Time,Place,Two Wheeler,Auto Rickshaw,Car/Utility,Buses,Trucks,Total_Vehicles,Traffic Situation
2024-04-01 00:00:00,Peelamedu,1,750,180,427,202,1560,Medium
2024-04-01 01:00:00,Hopes,4,648,249,433,1064,2398,High
2024-04-01 02:00:00,Hopes,2,773,215,424,895,2309,High
2024-04-01 03:00:00,Hopes,11,783,170,355,0,1319,Medium
2024-04-01 04:00:00,Hopes,4,733,172,0,0,909,Low
2024-04-01 05:00:00,Gandhipuram,16,757,159,448,1403,2783,High
2024-04-01 06:00:00,Hopes,13,710,174,500,679,2076,High
2024-04-01 07:00:00,Peelamedu,8,712,165,290,0,1175,Medium
2024-04-01 08:00:00,Gandhipuram,5,775,177,253,0,1210,Medium
2024-04-01 09:00:00,Hopes,4,684,163,491,252,1594,Medium
2024-04-01 10:00:00,Hopes,19,243,0,0,0,262,Low
2024-04-01 11:00:00,Peelamedu,8,751,171,497,251,1678,Medium
2024-04-01 12:00:00,Gandhipuram,20,693,184,471,682,2050,High
2024-04-01 13:00:00,Hopes,13,294,0,0,0,307,Low
2024-04-01 14:00:00,Gandhipuram,20,707,174,484,974,2359,High
2024-04-01 15:00:00,Hopes,14,634,212,293,0,1153,Medium
2024-04-01 16:00:00,Hopes,2,680,201,446,181,1510,Medium
2024-04-01 17:00:00,Hopes,8,606,202,418,342,1576,Medium
2024-04-01 18:00:00,Peelamedu,11,721,230,471,353,1786,Medium
2024-04-01 19:00:00,Gandhipuram,17,692,232,490,961,2392,High
2024-04-01 20:00:00,Peelamedu,4,647,181,492,107,1431,Medium
2024-04-01 21:00:00,Peelamedu,1,601,177,486,1001,2266,High
2024-04-01 22:00:00,Hopes,5,329,0,0,0,334,Low
2024-04-01 23:00:00,Hopes,0,174,0,0,0,174,Low
2024-04-02 00:00:00,Gandhipuram,11,619,155,0,0,785,Low
2024-04-02 01:00:00,Gandhipuram,0,754,161,402,578,1895,Medium
2024-04-02 02:00:00,Hopes,5,770,219,468,1220,2682,High
2024-04-02 03:00:00,Hopes,4,777,197,477,392,1847,Medium
2024-04-02 04:00:00,Hopes,20,53,0,0,0,73,Low
2024-04-02 05:00:00,Gandhipuram,17,671,246,364,0,1298,Medium
2024-04-02 06:00:00,Gandhipuram,6,768,202,301,0,1277,Medium
2024-04-02 07:00:00,Peelamedu,17,788,249,445,536,2035,High
2024-04-02 08:00:00,Hopes,0,627,77,0,0,704,Low
2024-04-02 09:00:00,Peelamedu,12,655,151,488,107,1413,Medium
2024-04-02 10:00:00,Hopes,7,632,196,144,0,979,Low
2024-04-02 11:00:00,Gandhipuram,4,2,0,0,0,6,Low
2024-04-02 12:00:00,Peelamedu,1,622,156,439,1034,2252,High
2024-04-02 13:00:00,Hopes,17,777,189,293,0,1276,Medium
2024-04-02 14:00:00,Gandhipuram,0,617,0,0,0,617,Low
2024-04-02 15:00:00,Gandhipuram,17,640,167,402,0,1226,Medium
2024-04-02 16:00:00,Gandhipuram,13,685,213,294,0,1205,Medium
2024-04-02 17:00:00,Gandhipuram,4,757,214,474,70,1519,Medium
2024-04-02 18:00:00,Hopes,2,330,0,0,0,332,Low
2024-04-02 19:00:00,Peelamedu,0,759,247,184,0,1190,Medium
2024-04-02 20:00:00,Peelamedu,5,790,238,406,1530,2969,High
2024-04-02 21:00:00,Gandhipuram,5,433,0,0,0,438,Low
2024-04-02 22:00:00,Peelamedu,14,790,65,0,0,869,Low
2024-04-02 23:00:00,Gandhipuram,12,756,161,476,1269,2674,High
2024-04-03 00:00:00,Peelamedu,0,775,161,440,652,2028,High
2024-04-03 01:00:00,Gandhipuram,12,621,206,466,997,2302,High
2024-04-03 02:00:00,Peelamedu,6,672,72,0,0,750,Low
2024-04-03 03:00:00,Hopes,15,612,179,347,0,1153,Medium
2024-04-03 04:00:00,Hopes,11,682,174,409,0,1276,Medium
2024-04-03 05:00:00,Gandhipuram,12,773,220,421,47,1473,Medium
2024-04-03 06:00:00,Hopes,6,720,214,450,1383,2773,High
2024-04-03 07:00:00,Hopes,4,706,164,423,671,1968,Medium
2024-04-03 08:00:00,Hopes,10,762,229,416,1575,2992,High
2024-04-03 09:00:00,Peelamedu,15,714,90,0,0,819,Low
2024-04-03 10:00:00,Gandhipuram,15,670,244,401,26,1356,Medium
2024-04-03 11:00:00,Peelamedu,3,764,228,2,0,997,Low
2024-04-03 12:00:00,Gandhipuram,13,768,245,445,763,2234,High
2024-04-03 13:00:00,Gandhipuram,1,229,0,0,0,230,Low
2024-04-03 14:00:00,Hopes,1,630,0,0,0,631,Low
2024-04-03 15:00:00,Gandhipuram,14,605,180,411,467,1677,Medium
2024-04-03 16:00:00,Peelamedu,19,606,150,428,1259,2462,High
2024-04-03 17:00:00,Hopes,10,795,204,407,230,1646,Medium
2024-04-03 18:00:00,Peelamedu,9,265,0,0,0,274,Low
2024-04-03 19:00:00,Hopes,12,691,244,495,484,1926,Medium
2024-04-03 20:00:00,Gandhipuram,10,150,0,0,0,160,Low
2024-04-03 21:00:00,Peelamedu,19,670,0,0,0,689,Low
2024-04-03 22:00:00,Hopes,10,626,215,446,1075,2372,High
2024-04-03 23:00:00,Peelamedu,7,762,238,477,341,1825,Medium
2024-04-04 00:00:00,Peelamedu,11,618,217,498,1265,2609,High
2024-04-04 01:00:00,Peelamedu,1,359,0,0,0,360,Low
2024-04-04 02:00:00,Peelamedu,11,625,160,0,0,796,Low
2024-04-04 03:00:00,Peelamedu,3,449,0,0,0,452,Low
2024-04-04 04:00:00,Gandhipuram,0,646,95,0,0,741,Low
2024-04-04 05:00:00,Gandhipuram,17,733,220,448,1296,2714,High
2024-04-04 06:00:00,Peelamedu,14,651,158,400,1723,2946,High
2024-04-04 07:00:00,Peelamedu,8,707,183,401,318,1617,Medium
2024-04-04 08:00:00,Gandhipuram,12,70,0,0,0,82,Low
2024-04-04 09:00:00,Hopes,13,578,0,0,0,591,Low
2024-04-04 10:00:00,Peelamedu,10,665,150,104,0,929,Low
2024-04-04 11:00:00,Peelamedu,10,643,199,122,0,974,Low
2024-04-04 12:00:00,Gandhipuram,17,693,197,84,0,991,Low
2024-04-04 13:00:00,Hopes,3,767,173,488,345,1776,Medium
2024-04-04 14:00:00,Gandhipuram,17,781,66,0,0,864,Low
2024-04-04 15:00:00,Hopes,5,662,239,470,1565,2941,High
2024-04-04 16:00:00,Peelamedu,18,583,0,0,0,601,Low
2024-04-04 17:00:00,Gandhipuram,8,663,0,0,0,671,Low
2024-04-04 18:00:00,Peelamedu,4,676,239,465,823,2207,High
2024-04-04 19:00:00,Peelamedu,17,441,0,0,0,458,Low
2024-04-04 20:00:00,Gandhipuram,4,60,0,0,0,64,Low
2024-04-04 21:00:00,Hopes,1,743,165,108,0,1017,Medium
2024-04-04 22:00:00,Peelamedu,9,28,0,0,0,37,Low
2024-04-04 23:00:00,Hopes,8,683,228,482,790,2191,High
2024-04-05 00:00:00,Hopes,8,655,150,496,1387,2696,High
2024-04-05 01:00:00,Gandhipuram,17,748,178,380,0,1323,Medium
2024-04-05 02:00:00,Gandhipuram,7,326,0,0,0,333,Low
2024-04-05 03:00:00,Gandhipuram,18,172,0,0,0,190,Low
2024-04-05 04:00:00,Hopes,14,797,217,288,0,1316,Medium
2024-04-05 05:00:00,Peelamedu,1,758,234,445,425,1863,Medium
2024-04-05 06:00:00,Gandhipuram,14,627,229,457,83,1410,Medium
2024-04-05 07:00:00,Hopes,1,743,187,429,1003,2363,High
2024-04-05 08:00:00,Gandhipuram,13,452,0,0,0,465,Low
2024-04-05 09:00:00,Gandhipuram,9,653,207,492,1413,2774,High
2024-04-05 10:00:00,Peelamedu,17,725,202,52,0,996,Low
2024-04-05 11:00:00,Peelamedu,5,612,0,0,0,617,Low
2024-04-05 12:00:00,Hopes,18,602,248,491,1466,2825,High
2024-04-05 13:00:00,Peelamedu,0,616,0,0,0,616,Low
2024-04-05 14:00:00,Hopes,12,87,0,0,0,99,Low
2024-04-05 15:00:00,Gandhipuram,15,615,169,192,0,991,Low
2024-04-05 16:00:00,Peelamedu,10,69,0,0,0,79,Low
2024-04-05 17:00:00,Gandhipuram,6,615,228,290,0,1139,Medium
2024-04-05 18:00:00,Peelamedu,8,458,0,0,0,466,Low
2024-04-05 19:00:00,Hopes,0,634,247,466,1497,2844,High
2024-04-05 20:00:00,Gandhipuram,9,765,172,340,0,1286,Medium
2024-04-05 21:00:00,Hopes,19,769,176,437,1416,2817,High
2024-04-05 22:00:00,Hopes,5,640,241,166,0,1052,Medium
2024-04-05 23:00:00,Peelamedu,0,660,183,475,1524,2842,High
2024-04-06 00:00:00,Gandhipuram,19,605,156,474,1166,2420,High
2024-04-06 01:00:00,Peelamedu,0,643,185,420,1548,2796,High
2024-04-06 02:00:00,Gandhipuram,2,652,238,451,1285,2628,High
2024-04-06 03:00:00,Hopes,6,711,5,0,0,722,Low
2024-04-06 04:00:00,Hopes,15,796,230,339,0,1380,Medium
2024-04-06 05:00:00,Hopes,11,716,139,0,0,866,Low
2024-04-06 06:00:00,Hopes,16,652,166,420,1516,2770,High
2024-04-06 07:00:00,Gandhipuram,4,732,247,410,266,1659,Medium
2024-04-06 08:00:00,Hopes,17,688,218,421,339,1683,Medium
2024-04-06 09:00:00,Gandhipuram,18,598,0,0,0,616,Low
2024-04-06 10:00:00,Peelamedu,9,582,0,0,0,591,Low
2024-04-06 11:00:00,Peelamedu,10,733,216,416,17,1392,Medium
2024-04-06 12:00:00,Peelamedu,2,626,163,475,96,1362,Medium
2024-04-06 13:00:00,Hopes,1,754,168,470,1457,2850,High
2024-04-06 14:00:00,Gandhipuram,0,759,0,0,0,759,Low
2024-04-06 15:00:00,Peelamedu,6,648,173,418,1297,2542,High
2024-04-06 16:00:00,Peelamedu,20,269,0,0,0,289,Low
2024-04-06 17:00:00,Gandhipuram,20,565,0,0,0,585,Low
2024-04-06 18:00:00,Hopes,3,160,0,0,0,163,Low
2024-04-06 19:00:00,Peelamedu,12,731,135,0,0,878,Low
2024-04-06 20:00:00,Peelamedu,5,627,185,46,0,863,Low
2024-04-06 21:00:00,Gandhipuram,3,676,223,443,1465,2810,High
2024-04-06 22:00:00,Peelamedu,3,769,154,497,1333,2756,High
2024-04-06 23:00:00,Hopes,7,785,191,477,237,1697,Medium
2024-04-07 00:00:00,Peelamedu,14,610,155,475,1624,2878,High
2024-04-07 01:00:00,Peelamedu,19,777,195,41,0,1032,Medium
2024-04-07 02:00:00,Hopes,19,681,173,457,1217,2547,High
2024-04-07 03:00:00,Gandhipuram,19,611,180,408,643,1861,Medium
2024-04-07 04:00:00,Hopes,17,649,191,406,1414,2677,High
2024-04-07 05:00:00,Peelamedu,13,201,0,0,0,214,Low
2024-04-07 06:00:00,Peelamedu,9,52,0,0,0,61,Low
2024-04-07 07:00:00,Hopes,13,733,159,360,0,1265,Medium
2024-04-07 08:00:00,Hopes,19,620,199,410,0,1248,Medium
2024-04-07 09:00:00,Gandhipuram,12,706,152,416,1654,2940,High
2024-04-07 10:00:00,Hopes,1,676,0,0,0,677,Low
2024-04-07 11:00:00,Gandhipuram,4,769,243,458,1002,2476,High
2024-04-07 12:00:00,Gandhipuram,7,693,128,0,0,828,Low
2024-04-07 13:00:00,Hopes,12,637,178,408,191,1426,Medium
2024-04-07 14:00:00,Gandhipuram,7,669,170,465,1572,2883,High
2024-04-07 15:00:00,Peelamedu,17,784,204,448,233,1686,Medium
2024-04-07 16:00:00,Hopes,14,536,0,0,0,550,Low
2024-04-07 17:00:00,Hopes,18,764,228,450,889,2349,High
2024-04-07 18:00:00,Gandhipuram,18,698,182,75,0,973,Low
2024-04-07 19:00:00,Hopes,8,678,207,500,1054,2447,High
2024-04-07 20:00:00,Peelamedu,0,773,193,410,558,1934,Medium
2024-04-07 21:00:00,Hopes,1,413,0,0,0,414,Low
2024-04-07 22:00:00,Hopes,10,755,214,201,0,1180,Medium
2024-04-07 23:00:00,Peelamedu,6,629,165,449,699,1948,Medium
2024-04-08 00:00:00,Peelamedu,11,541,0,0,0,552,Low
2024-04-08 01:00:00,Peelamedu,20,743,193,494,1391,2841,High
2024-04-08 02:00:00,Peelamedu,20,605,195,441,947,2208,High
2024-04-08 03:00:00,Hopes,19,636,161,499,1155,2470,High
2024-04-08 04:00:00,Peelamedu,9,769,221,467,1268,2734,High
2024-04-08 05:00:00,Hopes,15,772,176,491,489,1943,Medium
2024-04-08 06:00:00,Hopes,9,739,205,494,426,1873,Medium
2024-04-08 07:00:00,Hopes,9,685,176,485,1272,2627,High
2024-04-08 08:00:00,Hopes,6,785,216,340,0,1347,Medium
2024-04-08 09:00:00,Peelamedu,14,695,230,418,416,1773,Medium
2024-04-08 10:00:00,Peelamedu,16,618,172,479,927,2212,High
2024-04-08 11:00:00,Gandhipuram,13,789,168,460,994,2424,High
2024-04-08 12:00:00,Hopes,9,685,249,405,1583,2931,High
2024-04-08 13:00:00,Gandhipuram,2,731,198,447,629,2007,High
2024-04-08 14:00:00,Gandhipuram,18,669,151,426,1198,2462,High
2024-04-08 15:00:00,Peelamedu,3,714,213,401,56,1387,Medium
2024-04-08 16:00:00,Hopes,6,791,175,415,1569,2956,High
2024-04-08 17:00:00,Gandhipuram,11,764,238,468,1444,2925,High
2024-04-08 18:00:00,Gandhipuram,10,750,168,451,1248,2627,High
2024-04-08 19:00:00,Gandhipuram,7,628,190,417,1699,2941,High
2024-04-08 20:00:00,Hopes,7,679,168,473,1289,2616,High
2024-04-08 21:00:00,Hopes,4,785,177,452,938,2356,High
2024-04-08 22:00:00,Gandhipuram,16,757,169,451,91,1484,Medium
2024-04-08 23:00:00,Hopes,19,672,88,0,0,779,Low
2024-04-09 00:00:00,Hopes,3,772,137,0,0,912,Low
2024-04-09 01:00:00,Hopes,12,189,0,0,0,201,Low
2024-04-09 02:00:00,Hopes,7,623,194,423,536,1783,Medium
2024-04-09 03:00:00,Gandhipuram,4,621,13,0,0,638,Low
2024-04-09 04:00:00,Gandhipuram,1,711,229,445,1382,2768,High
2024-04-09 05:00:00,Hopes,0,763,213,453,1054,2483,High
2024-04-09 06:00:00,Hopes,13,650,164,1,0,828,Low
2024-04-09 07:00:00,Gandhipuram,19,787,197,454,437,1894,Medium
2024-04-09 08:00:00,Peelamedu,6,689,182,431,1271,2579,High
2024-04-09 09:00:00,Gandhipuram,17,641,234,465,1469,2826,High
2024-04-09 10:00:00,Gandhipuram,5,784,191,0,0,980,Low
2024-04-09 11:00:00,Peelamedu,3,678,194,412,333,1620,Medium
2024-04-09 12:00:00,Peelamedu,17,781,62,0,0,860,Low
2024-04-09 13:00:00,Hopes,3,632,239,339,0,1213,Medium
2024-04-09 14:00:00,Peelamedu,6,641,220,480,107,1454,Medium
2024-04-09 15:00:00,Hopes,17,391,0,0,0,408,Low
2024-04-09 16:00:00,Gandhipuram,9,780,193,149,0,1131,Medium
2024-04-09 17:00:00,Gandhipuram,3,612,158,413,976,2162,High
2024-04-09 18:00:00,Gandhipuram,14,716,0,0,0,730,Low
2024-04-09 19:00:00,Gandhipuram,7,636,191,488,1011,2333,High
2024-04-09 20:00:00,Peelamedu,6,652,233,488,1138,2517,High
2024-04-09 21:00:00,Peelamedu,0,609,199,400,1171,2379,High
2024-04-09 22:00:00,Peelamedu,4,637,247,487,1155,2530,High
2024-04-09 23:00:00,Hopes,0,678,184,429,1200,2491,High
2024-04-10 00:00:00,Gandhipuram,6,646,235,444,525,1856,Medium
2024-04-10 01:00:00,Peelamedu,12,638,212,492,73,1427,Medium
2024-04-10 02:00:00,Hopes,16,750,207,408,0,1381,Medium
2024-04-10 03:00:00,Hopes,2,782,221,430,190,1625,Medium
2024-04-10 04:00:00,Gandhipuram,20,741,210,0,0,971,Low
2024-04-10 05:00:00,Peelamedu,19,800,229,440,1187,2675,High
2024-04-10 06:00:00,Hopes,17,691,181,469,1293,2651,High
2024-04-10 07:00:00,Gandhipuram,5,684,243,443,1325,2700,High
2024-04-10 08:00:00,Peelamedu,17,78,0,0,0,95,Low
2024-04-10 09:00:00,Peelamedu,3,674,224,462,711,2074,High
2024-04-10 10:00:00,Gandhipuram,20,602,184,407,1591,2804,High
2024-04-10 11:00:00,Hopes,1,703,244,201,0,1149,Medium
2024-04-10 12:00:00,Hopes,9,649,185,473,476,1792,Medium
2024-04-10 13:00:00,Hopes,2,608,193,410,1404,2617,High
2024-04-10 14:00:00,Gandhipuram,7,607,231,113,0,958,Low
2024-04-10 15:00:00,Gandhipuram,4,600,158,442,1774,2978,High
2024-04-10 16:00:00,Hopes,5,744,161,467,1412,2789,High
2024-04-10 17:00:00,Gandhipuram,0,152,0,0,0,152,Low
2024-04-10 18:00:00,Gandhipuram,18,715,223,428,1349,2733,High
2024-04-10 19:00:00,Gandhipuram,19,760,190,374,0,1343,Medium
2024-04-10 20:00:00,Peelamedu,15,679,184,481,1195,2554,High
2024-04-10 21:00:00,Hopes,10,750,210,439,1286,2695,High
2024-04-10 22:00:00,Hopes,17,675,249,485,677,2103,High
2024-04-10 23:00:00,Hopes,5,618,158,464,521,1766,Medium
2024-04-11 00:00:00,Hopes,6,605,182,0,0,793,Low
2024-04-11 01:00:00,Peelamedu,19,800,229,81,0,1129,Medium
2024-04-11 02:00:00,Peelamedu,0,729,167,401,1244,2541,High
2024-04-11 03:00:00,Peelamedu,3,21,0,0,0,24,Low
2024-04-11 04:00:00,Hopes,1,629,90,0,0,720,Low
2024-04-11 05:00:00,Gandhipuram,20,66,0,0,0,86,Low
2024-04-11 06:00:00,Hopes,17,775,200,434,1098,2524,High
2024-04-11 07:00:00,Gandhipuram,1,731,0,0,0,732,Low
2024-04-11 08:00:00,Gandhipuram,6,739,243,426,753,2167,High
2024-04-11 09:00:00,Hopes,1,613,160,413,774,1961,Medium
2024-04-11 10:00:00,Peelamedu,20,743,239,97,0,1099,Medium
2024-04-11 11:00:00,Gandhipuram,2,651,247,65,0,965,Low
2024-04-11 12:00:00,Peelamedu,0,682,164,485,361,1692,Medium
2024-04-11 13:00:00,Gandhipuram,0,762,246,193,0,1201,Medium
2024-04-11 14:00:00,Hopes,3,780,206,406,137,1532,Medium
2024-04-11 15:00:00,Hopes,20,789,170,410,1369,2758,High
2024-04-11 16:00:00,Peelamedu,15,623,195,442,257,1532,Medium
2024-04-11 17:00:00,Peelamedu,12,484,0,0,0,496,Low
2024-04-11 18:00:00,Hopes,6,648,245,427,971,2297,High
2024-04-11 19:00:00,Gandhipuram,7,468,0,0,0,475,Low
2024-04-11 20:00:00,Peelamedu,18,267,0,0,0,285,Low
2024-04-11 21:00:00,Peelamedu,3,634,213,488,427,1765,Medium
2024-04-11 22:00:00,Gandhipuram,19,726,225,65,0,1035,Medium
2024-04-11 23:00:00,Peelamedu,1,675,150,425,1653,2904,High
2024-04-12 00:00:00,Hopes,3,493,0,0,0,496,Low
2024-04-12 01:00:00,Hopes,9,650,166,317,0,1142,Medium
2024-04-12 02:00:00,Peelamedu,10,44,0,0,0,54,Low
2024-04-12 03:00:00,Hopes,7,555,0,0,0,562,Low
2024-04-12 04:00:00,Gandhipuram,16,712,235,400,1078,2441,High
2024-04-12 05:00:00,Gandhipuram,13,13,0,0,0,26,Low
2024-04-12 06:00:00,Gandhipuram,20,669,156,67,0,912,Low
2024-04-12 07:00:00,Gandhipuram,5,658,187,489,585,1924,Medium
2024-04-12 08:00:00,Peelamedu,20,638,194,432,1385,2669,High
2024-04-12 09:00:00,Gandhipuram,10,120,0,0,0,130,Low
2024-04-12 10:00:00,Gandhipuram,12,732,214,486,1440,2884,High
2024-04-12 11:00:00,Peelamedu,2,721,188,447,687,2045,High
2024-04-12 12:00:00,Peelamedu,6,666,0,0,0,672,Low
2024-04-12 13:00:00,Hopes,5,54,0,0,0,59,Low
2024-04-12 14:00:00,Hopes,11,634,238,415,1076,2374,High
2024-04-12 15:00:00,Hopes,6,676,195,429,1290,2596,High
2024-04-12 16:00:00,Peelamedu,12,649,226,429,321,1637,Medium
2024-04-12 17:00:00,Hopes,17,656,231,429,412,1745,Medium
2024-04-12 18:00:00,Hopes,7,634,173,433,517,1764,Medium
2024-04-12 19:00:00,Gandhipuram,12,753,184,268,0,1217,Medium
2024-04-12 20:00:00,Gandhipuram,3,686,0,0,0,689,Low
2024-04-12 21:00:00,Hopes,15,232,0,0,0,247,Low
2024-04-12 22:00:00,Peelamedu,13,733,178,490,0,1414,Medium
2024-04-12 23:00:00,Hopes,20,662,199,201,0,1082,Medium
2024-04-13 00:00:00,Gandhipuram,0,691,159,453,1370,2673,High
2024-04-13 01:00:00,Peelamedu,1,640,217,432,1297,2587,High
2024-04-13 02:00:00,Hopes,10,624,245,430,3,1312,Medium
2024-04-13 03:00:00,Hopes,2,757,180,490,910,2339,High
2024-04-13 04:00:00,Hopes,20,688,153,445,6,1312,Medium
2024-04-13 05:00:00,Peelamedu,6,744,106,0,0,856,Low
2024-04-13 06:00:00,Peelamedu,0,744,230,403,0,1377,Medium
2024-04-13 07:00:00,Hopes,14,688,145,0,0,847,Low
2024-04-13 08:00:00,Hopes,13,689,189,368,0,1259,Medium
2024-04-13 09:00:00,Hopes,0,640,230,488,1415,2773,High
2024-04-13 10:00:00,Gandhipuram,5,798,207,457,1197,2664,High
2024-04-13 11:00:00,Hopes,14,734,210,443,1283,2684,High
2024-04-13 12:00:00,Hopes,3,689,224,429,1584,2929,High
2024-04-13 13:00:00,Hopes,14,673,168,484,1366,2705,High
2024-04-13 14:00:00,Hopes,10,702,176,17,0,905,Low
2024-04-13 15:00:00,Peelamedu,9,745,154,21,0,929,Low
2024-04-13 16:00:00,Hopes,9,723,154,477,1241,2604,High
2024-04-13 17:00:00,Gandhipuram,8,600,190,488,123,1409,Medium
2024-04-13 18:00:00,Hopes,5,543,0,0,0,548,Low
2024-04-13 19:00:00,Hopes,10,692,154,447,576,1879,Medium
2024-04-13 20:00:00,Peelamedu,6,633,237,468,400,1744,Medium
2024-04-13 21:00:00,Peelamedu,18,695,166,477,1598,2954,High
2024-04-13 22:00:00,Hopes,1,203,0,0,0,204,Low
2024-04-13 23:00:00,Gandhipuram,17,356,0,0,0,373,Low
2024-04-14 00:00:00,Gandhipuram,13,656,158,417,1232,2476,High
2024-04-14 01:00:00,Peelamedu,15,702,202,421,1153,2493,High
2024-04-14 02:00:00,Hopes,5,698,187,442,993,2325,High
2024-04-14 03:00:00,Gandhipuram,2,734,218,271,0,1225,Medium
2024-04-14 04:00:00,Peelamedu,11,129,0,0,0,140,Low
2024-04-14 05:00:00,Peelamedu,19,670,169,472,1604,2934,High
2024-04-14 06:00:00,Gandhipuram,10,714,192,455,1091,2462,High
2024-04-14 07:00:00,Gandhipuram,14,690,217,451,1326,2698,High
2024-04-14 08:00:00,Peelamedu,7,300,0,0,0,307,Low
2024-04-14 09:00:00,Peelamedu,16,710,225,422,1234,2607,High
2024-04-14 10:00:00,Peelamedu,0,630,181,404,1157,2372,High
2024-04-14 11:00:00,Gandhipuram,0,778,168,99,0,1045,Medium
2024-04-14 12:00:00,Gandhipuram,10,362,0,0,0,372,Low
2024-04-14 13:00:00,Peelamedu,4,662,0,0,0,666,Low
2024-04-14 14:00:00,Gandhipuram,6,752,209,485,1477,2929,High
2024-04-14 15:00:00,Peelamedu,19,762,244,426,483,1934,Medium
2024-04-14 16:00:00,Gandhipuram,7,651,226,429,307,1620,Medium
2024-04-14 17:00:00,Gandhipuram,16,643,199,461,21,1340,Medium
2024-04-14 18:00:00,Gandhipuram,13,660,180,475,699,2027,High
2024-04-14 19:00:00,Hopes,11,639,242,476,230,1598,Medium
2024-04-14 20:00:00,Hopes,1,729,150,159,0,1039,Medium
2024-04-14 21:00:00,Hopes,4,766,212,445,227,1654,Medium
2024-04-14 22:00:00,Gandhipuram,19,141,0,0,0,160,Low
2024-04-14 23:00:00,Hopes,10,448,0,0,0,458,Low
2024-04-15 00:00:00,Hopes,0,387,0,0,0,387,Low
2024-04-15 01:00:00,Gandhipuram,4,555,0,0,0,559,Low
2024-04-15 02:00:00,Gandhipuram,7,744,234,424,940,2349,High
2024-04-15 03:00:00,Hopes,7,695,182,498,1521,2903,High
2024-04-15 04:00:00,Gandhipuram,10,530,0,0,0,540,Low
2024-04-15 05:00:00,Hopes,19,681,250,499,471,1920,Medium
2024-04-15 06:00:00,Gandhipuram,17,711,234,407,0,1369,Medium
2024-04-15 07:00:00,Hopes,7,710,200,0,0,917,Low
2024-04-15 08:00:00,Gandhipuram,20,763,181,375,0,1339,Medium
2024-04-15 09:00:00,Gandhipuram,13,649,153,479,100,1394,Medium
2024-04-15 10:00:00,Peelamedu,14,783,185,469,12,1463,Medium
2024-04-15 11:00:00,Hopes,2,641,220,333,0,1196,Medium
2024-04-15 12:00:00,Peelamedu,20,745,169,414,1161,2509,High
2024-04-15 13:00:00,Gandhipuram,12,681,165,189,0,1047,Medium
2024-04-15 14:00:00,Hopes,20,572,0,0,0,592,Low
2024-04-15 15:00:00,Hopes,0,614,196,409,714,1933,Medium
2024-04-15 16:00:00,Gandhipuram,8,765,198,489,323,1783,Medium
2024-04-15 17:00:00,Hopes,3,758,163,255,0,1179,Medium
2024-04-15 18:00:00,Hopes,0,601,81,0,0,682,Low
2024-04-15 19:00:00,Peelamedu,2,601,180,155,0,938,Low
2024-04-15 20:00:00,Hopes,2,754,180,440,1299,2675,High
2024-04-15 21:00:00,Peelamedu,7,709,159,123,0,998,Low
2024-04-15 22:00:00,Peelamedu,19,62,0,0,0,81,Low
2024-04-15 23:00:00,Peelamedu,7,674,217,454,18,1370,Medium
2024-04-16 00:00:00,Hopes,8,432,0,0,0,440,Low
2024-04-16 01:00:00,Peelamedu,18,268,0,0,0,286,Low
2024-04-16 02:00:00,Peelamedu,17,687,188,411,1354,2657,High
2024-04-16 03:00:00,Peelamedu,3,702,217,462,153,1537,Medium
2024-04-16 04:00:00,Peelamedu,11,317,0,0,0,328,Low
2024-04-16 05:00:00,Peelamedu,13,735,175,444,990,2357,High
2024-04-16 06:00:00,Peelamedu,20,610,236,449,1067,2382,High
2024-04-16 07:00:00,Gandhipuram,9,656,153,336,0,1154,Medium
2024-04-16 08:00:00,Peelamedu,19,782,21,0,0,822,Low
2024-04-16 09:00:00,Peelamedu,14,734,229,383,0,1360,Medium
2024-04-16 10:00:00,Hopes,12,773,246,451,897,2379,High
2024-04-16 11:00:00,Hopes,1,41,0,0,0,42,Low
2024-04-16 12:00:00,Hopes,8,601,162,417,282,1470,Medium
2024-04-16 13:00:00,Gandhipuram,15,341,0,0,0,356,Low
2024-04-16 14:00:00,Gandhipuram,11,791,187,23,0,1012,Medium
2024-04-16 15:00:00,Hopes,9,669,160,493,1474,2805,High
2024-04-16 16:00:00,Peelamedu,14,65,0,0,0,79,Low
2024-04-16 17:00:00,Peelamedu,5,767,239,482,405,1898,Medium
2024-04-16 18:00:00,Gandhipuram,10,680,210,412,941,2253,High
2024-04-16 19:00:00,Hopes,3,762,175,469,751,2160,High
2024-04-16 20:00:00,Hopes,9,697,185,468,167,1526,Medium
2024-04-16 21:00:00,Peelamedu,11,63,0,0,0,74,Low
2024-04-16 22:00:00,Peelamedu,3,671,151,426,548,1799,Medium
2024-04-16 23:00:00,Gandhipuram,14,659,206,498,69,1446,Medium
2024-04-17 00:00:00,Hopes,8,796,232,337,0,1373,Medium
2024-04-17 01:00:00,Hopes,20,684,191,499,221,1615,Medium
2024-04-17 02:00:00,Hopes,1,779,150,410,1239,2579,High
2024-04-17 03:00:00,Gandhipuram,18,242,0,0,0,260,Low
2024-04-17 04:00:00,Peelamedu,20,711,213,133,0,1077,Medium
2024-04-17 05:00:00,Hopes,12,670,161,477,1273,2593,High
2024-04-17 06:00:00,Peelamedu,12,58,0,0,0,70,Low
2024-04-17 07:00:00,Peelamedu,8,716,191,405,97,1417,Medium
2024-04-17 08:00:00,Peelamedu,19,635,234,378,0,1266,Medium
2024-04-17 09:00:00,Peelamedu,9,571,0,0,0,580,Low
2024-04-17 10:00:00,Hopes,9,293,0,0,0,302,Low
2024-04-17 11:00:00,Gandhipuram,18,509,0,0,0,527,Low
2024-04-17 12:00:00,Peelamedu,0,675,214,91,0,980,Low
2024-04-17 13:00:00,Hopes,18,545,0,0,0,563,Low
2024-04-17 14:00:00,Gandhipuram,16,771,183,489,262,1721,Medium
2024-04-17 15:00:00,Hopes,19,685,198,399,0,1301,Medium
2024-04-17 16:00:00,Gandhipuram,9,664,171,497,684,2025,High
2024-04-17 17:00:00,Hopes,19,666,81,0,0,766,Low
2024-04-17 18:00:00,Hopes,3,785,215,428,402,1833,Medium
2024-04-17 19:00:00,Peelamedu,8,605,211,409,1268,2501,High
2024-04-17 20:00:00,Gandhipuram,20,630,223,461,242,1576,Medium
2024-04-17 21:00:00,Peelamedu,19,733,167,403,74,1396,Medium
2024-04-17 22:00:00,Gandhipuram,5,798,99,0,0,902,Low
2024-04-17 23:00:00,Peelamedu,0,775,164,431,1411,2781,High
2024-04-18 00:00:00,Gandhipuram,15,612,239,142,0,1008,Medium
2024-04-18 01:00:00,Hopes,3,774,230,500,245,1752,Medium
2024-04-18 02:00:00,Gandhipuram,16,727,19,0,0,762,Low
2024-04-18 03:00:00,Hopes,6,779,238,167,0,1190,Medium
2024-04-18 04:00:00,Hopes,6,696,110,0,0,812,Low
2024-04-18 05:00:00,Gandhipuram,0,752,233,402,0,1387,Medium
2024-04-18 06:00:00,Peelamedu,3,653,184,463,740,2043,High
2024-04-18 07:00:00,Hopes,11,260,0,0,0,271,Low
2024-04-18 08:00:00,Gandhipuram,18,800,200,425,850,2293,High
2024-04-18 09:00:00,Peelamedu,10,715,158,488,776,2147,High
2024-04-18 10:00:00,Peelamedu,16,37,0,0,0,53,Low
2024-04-18 11:00:00,Hopes,3,734,82,0,0,819,Low
2024-04-18 12:00:00,Peelamedu,10,328,0,0,0,338,Low
2024-04-18 13:00:00,Peelamedu,20,779,245,445,581,2070,High
2024-04-18 14:00:00,Gandhipuram,4,722,230,484,345,1785,Medium
2024-04-18 15:00:00,Hopes,12,626,0,0,0,638,Low
2024-04-18 16:00:00,Peelamedu,11,682,235,405,108,1441,Medium
2024-04-18 17:00:00,Gandhipuram,4,684,237,430,1400,2755,High
2024-04-18 18:00:00,Gandhipuram,2,652,245,444,1580,2923,High
2024-04-18 19:00:00,Hopes,9,618,169,92,0,888,Low
2024-04-18 20:00:00,Hopes,17,784,212,414,451,1878,Medium
2024-04-18 21:00:00,Hopes,6,615,235,488,1107,2451,High
2024-04-18 22:00:00,Hopes,3,667,154,433,657,1914,Medium
2024-04-18 23:00:00,Peelamedu,9,777,249,167,0,1202,Medium
2024-04-19 00:00:00,Hopes,12,758,213,489,631,2103,High
2024-04-19 01:00:00,Peelamedu,19,672,0,0,0,691,Low
2024-04-19 02:00:00,Gandhipuram,9,0,0,0,0,9,Low
2024-04-19 03:00:00,Gandhipuram,13,569,0,0,0,582,Low
2024-04-19 04:00:00,Gandhipuram,1,747,218,404,32,1402,Medium
2024-04-19 05:00:00,Peelamedu,0,791,47,0,0,838,Low
2024-04-19 06:00:00,Hopes,20,465,0,0,0,485,Low
2024-04-19 07:00:00,Gandhipuram,17,715,207,312,0,1251,Medium
2024-04-19 08:00:00,Hopes,12,730,204,0,0,946,Low
2024-04-19 09:00:00,Gandhipuram,16,660,163,493,780,2112,High
2024-04-19 10:00:00,Hopes,3,797,207,488,887,2382,High
2024-04-19 11:00:00,Gandhipuram,15,600,183,408,103,1309,Medium
2024-04-19 12:00:00,Peelamedu,16,768,235,441,166,1626,Medium
2024-04-19 13:00:00,Hopes,11,612,245,446,1108,2422,High
2024-04-19 14:00:00,Peelamedu,14,783,180,446,1199,2622,High
2024-04-19 15:00:00,Gandhipuram,9,495,0,0,0,504,Low
2024-04-19 16:00:00,Gandhipuram,14,680,170,427,801,2092,High
2024-04-19 17:00:00,Peelamedu,3,635,188,405,259,1490,Medium
2024-04-19 18:00:00,Gandhipuram,10,763,238,402,1191,2604,High
2024-04-19 19:00:00,Hopes,18,656,227,417,1025,2343,High
2024-04-19 20:00:00,Gandhipuram,12,687,243,442,895,2279,High
2024-04-19 21:00:00,Hopes,11,572,0,0,0,583,Low
2024-04-19 22:00:00,Peelamedu,12,652,216,489,769,2138,High
2024-04-19 23:00:00,Peelamedu,14,778,205,414,913,2324,High
2024-04-20 00:00:00,Peelamedu,1,719,176,412,217,1525,Medium
2024-04-20 01:00:00,Peelamedu,1,771,176,429,571,1948,Medium
2024-04-20 02:00:00,Hopes,4,82,0,0,0,86,Low
2024-04-20 03:00:00,Peelamedu,6,692,0,0,0,698,Low
2024-04-20 04:00:00,Peelamedu,18,642,151,0,0,811,Low
2024-04-20 05:00:00,Hopes,17,778,225,442,201,1663,Medium
2024-04-20 06:00:00,Hopes,3,188,0,0,0,191,Low
2024-04-20 07:00:00,Gandhipuram,18,660,237,484,1497,2896,High
2024-04-20 08:00:00,Hopes,1,620,186,423,599,1829,Medium
2024-04-20 09:00:00,Peelamedu,10,721,152,461,1055,2399,High
2024-04-20 10:00:00,Gandhipuram,4,233,0,0,0,237,Low
2024-04-20 11:00:00,Hopes,0,7,0,0,0,7,Low
2024-04-20 12:00:00,Gandhipuram,11,285,0,0,0,296,Low
2024-04-20 13:00:00,Gandhipuram,17,392,0,0,0,409,Low
2024-04-20 14:00:00,Gandhipuram,20,717,191,417,1234,2579,High
2024-04-20 15:00:00,Gandhipuram,15,660,180,423,965,2243,High
2024-04-20 16:00:00,Hopes,1,97,0,0,0,98,Low
2024-04-20 17:00:00,Hopes,6,166,0,0,0,172,Low
2024-04-20 18:00:00,Gandhipuram,12,745,198,85,0,1040,Medium
2024-04-20 19:00:00,Peelamedu,16,730,173,471,1058,2448,High
2024-04-20 20:00:00,Hopes,1,731,212,427,1325,2696,High
2024-04-20 21:00:00,Hopes,19,326,0,0,0,345,Low
2024-04-20 22:00:00,Hopes,20,655,244,475,1133,2527,High
2024-04-20 23:00:00,Hopes,18,671,243,312,0,1244,Medium
2024-04-21 00:00:00,Gandhipuram,2,537,0,0,0,539,Low
2024-04-21 01:00:00,Hopes,11,614,210,414,893,2142,High
2024-04-21 02:00:00,Hopes,9,111,0,0,0,120,Low
2024-04-21 03:00:00,Gandhipuram,5,672,12,0,0,689,Low
2024-04-21 04:00:00,Gandhipuram,16,624,232,438,1580,2890,High
2024-04-21 05:00:00,Peelamedu,4,658,202,420,1452,2736,High
2024-04-21 06:00:00,Hopes,8,784,208,92,0,1092,Medium
2024-04-21 07:00:00,Gandhipuram,9,707,219,419,193,1547,Medium
2024-04-21 08:00:00,Peelamedu,0,106,0,0,0,106,Low
2024-04-21 09:00:00,Peelamedu,8,640,216,489,1528,2881,High
2024-04-21 10:00:00,Gandhipuram,14,697,189,489,27,1416,Medium
2024-04-21 11:00:00,Peelamedu,3,611,165,498,1458,2735,High
2024-04-21 12:00:00,Hopes,11,707,244,418,1294,2674,High
2024-04-21 13:00:00,Gandhipuram,14,512,0,0,0,526,Low
2024-04-21 14:00:00,Hopes,14,787,172,113,0,1086,Medium
2024-04-21 15:00:00,Peelamedu,5,620,240,431,1176,2472,High
2024-04-21 16:00:00,Gandhipuram,12,610,241,484,318,1665,Medium
2024-04-21 17:00:00,Peelamedu,6,767,212,175,0,1160,Medium
2024-04-21 18:00:00,Gandhipuram,11,414,0,0,0,425,Low
2024-04-21 19:00:00,Gandhipuram,10,630,193,313,0,1146,Medium

