Time,Place,Two Wheeler,Auto Rickshaw,Car/Utility,Buses,Trucks,Total_Vehicles,Traffic Situation
2024-08-14 23:42:31.605066,Peelamedu,56,27,107,16,10,216,Moderate
2024-08-04 22:35:31.605066,Peelamedu,20,16,111,11,7,165,Low
2024-08-04 12:53:31.605066,Peelamedu,18,14,66,9,15,122,Moderate
2024-08-25 23:33:31.605066,Peelamedu,42,50,13,15,14,134,Moderate
2024-08-05 11:04:31.605066,Peelamedu,55,40,128,3,10,236,Moderate
2024-08-30 13:42:31.605066,Peelamedu,75,26,136,8,18,263,Moderate
2024-08-16 09:48:31.605066,Peelamedu,49,12,2,1,0,64,Moderate
2024-09-09 01:13:31.605066,Peelamedu,15,21,35,11,5,87,Low
2024-08-06 01:18:31.605066,Peelamedu,86,34,135,15,18,288,Moderate
2024-08-11 08:53:31.605066,Peelamedu,43,34,114,7,29,227,Low
2024-08-29 15:16:31.605066,Peelamedu,86,19,22,9,0,136,High
2024-09-19 21:28:31.605066,Peelamedu,77,41,70,10,8,206,High
2024-08-25 01:43:31.605066,Peelamedu,63,4,41,11,6,125,Moderate
2024-09-25 22:37:31.605066,Peelamedu,24,27,107,3,16,177,High
2024-08-01 04:20:31.605066,Peelamedu,43,29,26,19,25,142,Moderate
2024-08-30 15:31:31.605066,Peelamedu,76,25,75,18,21,215,Moderate
2024-09-16 17:17:31.605066,Peelamedu,36,49,121,8,3,217,High
2024-09-01 13:11:31.605066,Peelamedu,40,11,57,13,25,146,High
2024-08-09 10:38:31.605066,Peelamedu,15,17,4,5,4,45,High
2024-09-20 10:49:31.605066,Peelamedu,16,37,20,18,24,115,Low
2024-08-04 00:59:31.605066,Peelamedu,81,43,67,15,26,232,High
2024-09-16 19:28:31.605066,Peelamedu,96,9,147,5,6,263,Moderate
2024-09-16 16:46:31.605066,Peelamedu,24,17,105,1,8,155,Low
2024-08-08 21:33:31.605066,Peelamedu,42,48,124,0,11,225,Low
2024-08-07 12:09:31.605066,Peelamedu,5,2,106,0,1,114,Low
2024-09-21 02:41:31.605066,Peelamedu,97,21,55,3,30,206,Low
2024-09-21 04:54:31.605066,Peelamedu,25,40,141,14,12,232,High
2024-08-14 04:37:31.605066,Peelamedu,21,26,28,10,19,104,High
2024-09-04 12:02:31.605066,Peelamedu,81,27,6,2,8,124,Low
2024-08-18 14:31:31.605066,Peelamedu,67,4,107,7,4,189,Low
2024-09-23 19:43:31.605066,Peelamedu,45,37,130,19,28,259,High
2024-09-05 19:38:31.605066,Peelamedu,81,31,71,17,16,216,Low
2024-08-26 06:55:31.605066,Peelamedu,56,22,115,14,19,226,Low
2024-09-13 19:23:31.605066,Peelamedu,82,47,97,13,14,253,Moderate
2024-09-06 07:49:31.605066,Peelamedu,38,26,106,4,7,181,Moderate
2024-08-06 11:14:31.605066,Peelamedu,94,9,46,16,9,174,Low
2024-08-17 20:29:31.605066,Peelamedu,30,44,43,9,12,138,Low
2024-09-08 07:29:31.605066,Peelamedu,1,38,112,11,18,180,Moderate
2024-08-21 11:43:31.605066,Peelamedu,16,36,58,19,10,139,Low
2024-09-02 20:42:31.605066,Peelamedu,33,24,9,5,0,71,Low
2024-08-31 05:55:31.605066,Peelamedu,92,29,110,6,29,266,High
2024-08-25 20:56:31.605066,Peelamedu,49,14,83,10,7,163,Moderate
2024-09-21 13:30:31.605066,Peelamedu,90,39,87,7,19,242,Low
2024-09-06 04:02:31.605066,Peelamedu,37,48,121,1,0,207,High
2024-08-17 19:06:31.605066,Peelamedu,90,40,77,14,23,244,Low
2024-08-04 08:57:31.605066,Peelamedu,52,29,118,5,2,206,Low
2024-08-19 07:02:31.605066,Peelamedu,9,18,37,18,9,91,Moderate
2024-08-16 08:26:31.605066,Peelamedu,74,7,107,10,9,207,Moderate
2024-07-30 23:27:31.605066,Peelamedu,77,4,50,0,24,155,Moderate
2024-09-18 02:02:31.605066,Peelamedu,65,8,47,2,4,126,Low
2024-09-11 17:20:31.605066,Peelamedu,82,32,121,1,17,253,Moderate
2024-09-17 23:30:31.605066,Peelamedu,66,28,59,2,17,172,Low
2024-09-20 05:15:31.605066,Peelamedu,89,44,34,11,30,208,High
2024-09-15 18:22:31.605066,Peelamedu,92,35,80,9,25,241,High
2024-09-22 20:08:31.605066,Peelamedu,87,3,115,17,19,241,Low
2024-08-07 16:22:31.605066,Peelamedu,14,15,37,11,15,92,High
2024-07-31 13:58:31.605066,Peelamedu,57,17,119,20,4,217,High
2024-08-16 14:47:31.605066,Peelamedu,94,8,90,9,24,225,Low
2024-09-12 08:46:31.605066,Peelamedu,21,39,39,8,24,131,Moderate
2024-09-16 00:18:31.605066,Peelamedu,70,24,90,19,2,205,Low
2024-08-08 11:50:31.605066,Peelamedu,82,39,23,15,14,173,Moderate
2024-08-22 18:42:31.605066,Peelamedu,67,41,123,6,8,245,Low
2024-08-12 22:38:31.605066,Peelamedu,8,11,121,3,16,159,Low
2024-09-10 16:47:31.605066,Peelamedu,24,38,139,13,27,241,High
2024-08-22 00:53:31.605066,Peelamedu,82,36,145,20,9,292,High
2024-08-25 16:02:31.605066,Peelamedu,64,28,114,16,23,245,High
2024-07-30 17:06:31.605066,Peelamedu,89,40,110,1,10,250,High
2024-08-10 03:57:31.605066,Peelamedu,27,32,135,5,10,209,High
2024-07-31 22:40:31.605066,Peelamedu,53,1,61,14,26,155,Low
2024-08-30 18:41:31.605066,Peelamedu,13,5,3,4,13,38,High
2024-08-16 06:53:31.605066,Peelamedu,98,4,100,19,7,228,Low
2024-08-28 05:57:31.605066,Peelamedu,8,5,66,17,9,105,Moderate
2024-08-29 14:29:31.605066,Peelamedu,71,35,94,6,10,216,Moderate
2024-08-22 15:13:31.605066,Peelamedu,37,35,120,16,25,233,High
2024-09-07 02:09:31.605066,Peelamedu,34,48,27,19,19,147,Moderate
2024-09-16 21:47:31.605066,Peelamedu,63,44,58,8,25,198,Low
2024-08-14 18:14:31.605066,Peelamedu,32,21,113,3,30,199,High
2024-09-11 22:42:31.605066,Peelamedu,49,39,10,11,5,114,Low
2024-09-12 00:44:31.605066,Peelamedu,56,3,102,19,20,200,High
2024-09-19 15:06:31.605066,Peelamedu,68,38,60,16,15,197,Low
2024-08-22 17:09:31.605066,Peelamedu,39,17,47,13,26,142,Low
2024-08-06 11:56:31.605066,Peelamedu,17,1,47,2,22,89,Low
2024-09-11 18:15:31.605066,Peelamedu,79,42,5,14,20,160,Moderate
2024-08-17 07:39:31.605066,Peelamedu,62,6,71,5,24,168,Low
2024-09-16 01:18:31.605066,Peelamedu,96,18,124,6,12,256,Low
2024-09-03 03:27:31.605066,Peelamedu,65,17,115,11,26,234,Low
2024-08-08 04:13:31.605066,Peelamedu,11,9,85,1,24,130,Moderate
2024-08-14 03:26:31.605066,Peelamedu,2,8,74,5,13,102,Moderate
2024-09-15 19:24:31.605066,Peelamedu,32,40,10,15,7,104,High
2024-09-24 13:44:31.605066,Peelamedu,26,25,70,16,1,138,Low
2024-09-15 00:54:31.605066,Peelamedu,55,46,65,0,24,190,Moderate
2024-09-16 05:56:31.605066,Peelamedu,9,4,134,3,25,175,Moderate
2024-08-05 06:29:31.605066,Peelamedu,53,30,145,8,15,251,Moderate
2024-09-04 11:28:31.605066,Peelamedu,1,28,59,9,29,126,Low
2024-09-20 12:10:31.605066,Peelamedu,47,41,76,10,17,191,High
2024-09-25 23:39:31.605066,Peelamedu,64,38,143,9,5,259,Moderate
2024-08-18 05:58:31.605066,Peelamedu,84,14,47,8,23,176,Moderate
2024-08-21 03:25:31.605066,Peelamedu,91,0,61,11,24,187,Moderate
2024-09-08 10:16:31.605066,Peelamedu,98,23,46,11,1,179,Moderate
2024-09-01 06:08:31.605066,Peelamedu,48,21,134,5,11,219,High
2024-09-01 18:49:31.605066,Peelamedu,7,27,28,3,20,85,High
2024-08-14 20:31:31.605066,Peelamedu,15,48,97,16,25,201,High
2024-08-24 02:43:31.605066,Peelamedu,32,32,93,12,12,181,Moderate
2024-08-08 21:47:31.605066,Peelamedu,83,19,40,14,3,159,Low
2024-08-22 21:09:31.605066,Peelamedu,2,34,141,7,8,192,Moderate
2024-08-04 02:50:31.605066,Peelamedu,90,2,85,19,7,203,High
2024-08-25 12:17:31.605066,Peelamedu,61,1,39,3,5,109,Low
2024-08-12 19:51:31.605066,Peelamedu,34,38,111,18,5,206,Moderate
2024-09-19 18:32:31.605066,Peelamedu,17,34,32,16,10,109,Low
2024-08-27 11:26:31.605066,Peelamedu,76,32,142,4,20,274,Low
2024-09-24 22:06:31.605066,Peelamedu,19,2,127,5,14,167,Moderate
2024-08-30 02:47:31.605066,Peelamedu,82,39,36,9,6,172,Low
2024-09-10 15:36:31.605066,Peelamedu,72,14,148,9,30,273,High
2024-08-11 03:45:31.605066,Peelamedu,82,6,129,2,28,247,High
2024-08-04 06:50:31.605066,Peelamedu,69,19,44,10,9,151,High
2024-07-31 11:14:31.605066,Peelamedu,24,11,90,7,21,153,Moderate
2024-08-03 00:26:31.605066,Peelamedu,42,42,10,18,13,125,High
2024-09-15 02:34:31.605066,Peelamedu,54,42,103,7,9,215,High
2024-08-23 05:13:31.605066,Peelamedu,85,43,128,20,22,298,High
2024-08-18 11:17:31.605066,Peelamedu,49,17,102,13,8,189,Moderate
2024-09-05 14:08:31.605066,Peelamedu,87,50,118,1,16,272,High
2024-07-28 09:53:31.605066,Peelamedu,1,13,20,5,3,42,High
2024-08-27 06:46:31.605066,Peelamedu,91,2,48,12,3,156,High
2024-09-11 06:02:31.605066,Peelamedu,83,34,113,15,17,262,High
2024-09-21 16:18:31.605066,Peelamedu,68,30,0,4,7,109,Moderate
2024-09-06 17:23:31.605066,Peelamedu,64,48,115,10,7,244,Low
2024-08-11 09:55:31.605066,Peelamedu,77,5,143,10,18,253,Low
2024-09-02 12:59:31.605066,Peelamedu,13,9,52,15,6,95,High
2024-08-13 02:52:31.605066,Peelamedu,39,21,34,5,11,110,High
2024-08-19 05:36:31.605066,Peelamedu,5,14,13,19,29,80,Low
2024-09-16 19:30:31.605066,Peelamedu,62,24,131,15,29,261,Low
2024-08-23 04:52:31.605066,Peelamedu,94,4,114,9,11,232,High
2024-09-03 23:36:31.605066,Peelamedu,2,38,131,18,30,219,Moderate
2024-08-31 05:53:31.605066,Peelamedu,99,38,23,19,10,189,High
2024-09-15 12:29:31.605066,Peelamedu,34,11,55,15,4,119,High
2024-07-30 08:13:31.605066,Peelamedu,28,48,64,5,28,173,Low
2024-09-05 14:44:31.605066,Peelamedu,77,18,41,18,20,174,Low
2024-07-31 21:42:31.605066,Peelamedu,8,50,57,12,17,144,High
2024-08-10 04:18:31.605066,Peelamedu,60,9,68,2,15,154,High
2024-08-28 08:41:31.605066,Peelamedu,45,50,60,20,10,185,Low
2024-08-14 05:49:31.605066,Peelamedu,54,43,1,13,10,121,Low
2024-08-26 14:13:31.605066,Peelamedu,12,46,29,14,22,123,Moderate
2024-08-23 19:11:31.605066,Peelamedu,96,27,99,4,23,249,Moderate
2024-09-11 14:06:31.605066,Peelamedu,17,14,99,8,26,164,High
2024-09-02 11:08:31.605066,Peelamedu,9,31,26,7,27,100,Moderate
2024-09-14 05:01:31.605066,Peelamedu,4,13,42,11,15,85,High
2024-08-01 08:04:31.605066,Peelamedu,17,14,101,0,7,139,Moderate
2024-08-25 19:49:31.605066,Peelamedu,11,21,96,10,11,149,Moderate
2024-08-08 23:43:31.605066,Peelamedu,29,11,111,6,16,173,High
2024-08-07 12:18:31.605066,Peelamedu,98,21,62,7,12,200,High
2024-08-24 04:12:31.605066,Peelamedu,9,13,137,10,14,183,High
2024-08-02 02:11:31.605066,Peelamedu,72,43,88,17,12,232,Moderate
2024-09-04 06:53:31.605066,Peelamedu,84,6,40,16,11,157,Moderate
2024-07-27 12:40:31.605066,Peelamedu,36,24,104,1,6,171,Low
2024-08-24 15:41:31.605066,Peelamedu,84,49,107,10,4,254,Low
2024-07-29 10:01:31.605066,Peelamedu,49,11,36,0,20,116,High
2024-07-27 15:17:31.605066,Peelamedu,52,22,117,12,9,212,High
2024-08-03 21:27:31.605066,Peelamedu,95,14,114,4,6,233,High
2024-08-10 13:31:31.605066,Peelamedu,85,0,81,1,21,188,Low
2024-09-19 09:34:31.605066,Peelamedu,66,4,1,15,13,99,Low
2024-08-31 14:27:31.605066,Peelamedu,18,11,47,2,10,88,High
2024-08-10 18:57:31.605066,Peelamedu,32,34,86,3,12,167,Low
2024-09-08 01:24:31.605066,Peelamedu,69,25,81,8,30,213,High
2024-08-02 13:55:31.605066,Peelamedu,83,14,52,7,9,165,High
2024-08-30 10:02:31.605066,Peelamedu,84,25,10,11,1,131,Low
2024-09-13 04:16:31.605066,Peelamedu,78,39,63,8,2,190,Low
2024-08-19 06:43:31.605066,Peelamedu,76,8,135,14,29,262,High
2024-09-02 15:28:31.605066,Peelamedu,79,12,119,19,5,234,High
2024-07-27 19:54:31.605066,Peelamedu,57,26,81,10,1,175,High
2024-08-14 16:50:31.605066,Peelamedu,19,46,70,16,4,155,Moderate
2024-09-11 06:15:31.605066,Peelamedu,45,30,92,5,5,177,High
2024-09-17 09:10:31.605066,Peelamedu,86,38,39,20,15,198,Low
2024-08-08 00:33:31.605066,Peelamedu,6,13,15,1,5,40,Low
2024-09-13 16:40:31.605066,Peelamedu,6,7,103,17,15,148,Low
2024-09-13 02:18:31.605066,Peelamedu,60,37,133,0,24,254,High
2024-09-13 15:56:31.605066,Peelamedu,100,5,90,12,4,211,Low
2024-09-18 20:49:31.605066,Peelamedu,10,40,41,13,23,127,Low
2024-09-15 13:28:31.605066,Peelamedu,61,13,143,0,22,239,Moderate
2024-09-07 04:12:31.605066,Peelamedu,6,46,113,18,27,210,High
2024-08-29 20:48:31.605066,Peelamedu,61,27,108,7,19,222,Moderate
2024-09-17 15:32:31.605066,Peelamedu,92,32,130,19,22,295,Moderate
2024-09-15 20:12:31.605066,Peelamedu,25,0,60,12,17,114,Moderate
2024-09-16 17:57:31.605066,Peelamedu,10,25,93,5,24,157,Moderate
2024-09-06 11:23:31.605066,Peelamedu,75,48,105,11,21,260,High
2024-09-20 22:04:31.605066,Peelamedu,38,28,47,0,12,125,Low
2024-08-28 01:20:31.605066,Peelamedu,15,39,72,2,22,150,High
2024-08-29 12:26:31.605066,Peelamedu,74,14,9,1,17,115,High
2024-09-20 08:14:31.605066,Peelamedu,35,43,19,16,4,117,High
2024-07-29 19:25:31.605066,Peelamedu,13,8,42,12,28,103,Low
2024-08-16 21:19:31.605066,Peelamedu,71,35,117,16,0,239,High
2024-08-25 21:35:31.605066,Peelamedu,52,8,46,5,11,122,Moderate
2024-08-26 15:44:31.605066,Peelamedu,84,50,130,7,22,293,Low
2024-08-28 04:38:31.605066,Peelamedu,58,46,47,16,12,179,High
2024-09-15 21:39:31.605066,Peelamedu,58,41,70,6,26,201,Moderate
2024-08-06 03:51:31.605066,Peelamedu,29,6,39,13,12,99,Moderate
2024-08-24 15:41:31.605066,Peelamedu,70,20,96,15,28,229,Low
2024-09-09 13:49:31.605066,Peelamedu,59,34,50,1,1,145,Low
2024-09-23 15:42:31.605066,Peelamedu,16,10,150,20,19,215,Moderate
2024-09-22 12:43:31.605066,Peelamedu,31,50,115,6,1,203,Low
2024-09-12 21:14:31.605066,Peelamedu,33,39,22,6,21,121,Low
2024-08-18 01:57:31.605066,Peelamedu,49,15,35,10,15,124,Moderate
2024-08-30 01:38:31.605066,Peelamedu,94,31,80,5,22,232,Low
2024-07-30 10:46:31.605066,Peelamedu,11,29,85,4,12,141,High
2024-09-10 04:10:31.605066,Peelamedu,87,46,37,12,20,202,Moderate
2024-09-15 15:01:31.605066,Peelamedu,47,35,74,2,11,169,High
2024-08-26 13:09:31.605066,Peelamedu,81,10,85,12,6,194,Moderate
2024-08-31 09:21:31.605066,Peelamedu,51,11,101,1,28,192,High
2024-09-26 05:38:31.605066,Peelamedu,78,23,87,7,28,223,High
2024-08-03 08:29:31.605066,Peelamedu,90,28,84,3,14,219,Low
2024-08-13 12:30:31.605066,Peelamedu,8,48,56,10,11,133,Low
2024-07-28 15:01:31.605066,Peelamedu,64,33,8,12,7,124,Low
2024-08-02 14:43:31.605066,Peelamedu,42,13,89,16,7,167,High
2024-07-31 16:57:31.605066,Peelamedu,9,41,129,3,15,197,Moderate
2024-08-10 22:47:31.605066,Peelamedu,73,21,134,16,28,272,High
2024-08-20 04:16:31.605066,Peelamedu,44,4,134,7,30,219,Moderate
2024-09-18 04:59:31.605066,Peelamedu,100,2,67,17,8,194,High
2024-09-18 11:32:31.605066,Peelamedu,64,46,133,0,2,245,Moderate
2024-08-08 02:45:31.605066,Peelamedu,23,42,13,11,30,119,Moderate
2024-07-29 00:18:31.605066,Peelamedu,59,32,17,8,30,146,Moderate
2024-08-10 16:09:31.605066,Peelamedu,38,13,76,16,18,161,Moderate
2024-08-06 12:40:31.605066,Peelamedu,90,35,138,14,17,294,Moderate
2024-07-30 10:22:31.605066,Peelamedu,63,47,134,11,14,269,High
2024-09-06 13:00:31.605066,Peelamedu,3,18,139,5,15,180,Moderate
2024-08-14 05:37:31.605066,Peelamedu,49,19,8,15,23,114,Low
2024-09-24 07:06:31.605066,Peelamedu,83,4,121,19,21,248,High
2024-08-29 21:03:31.605066,Peelamedu,85,6,40,9,2,142,High
2024-08-28 02:02:31.605066,Peelamedu,52,3,43,14,7,119,High
2024-09-09 15:36:31.605066,Peelamedu,51,43,90,1,22,207,Moderate
2024-08-15 22:13:31.605066,Peelamedu,98,50,14,10,16,188,Low
2024-08-24 17:07:31.605066,Peelamedu,32,39,30,11,21,133,High
2024-08-03 02:39:31.605066,Peelamedu,20,24,65,15,6,130,Low
2024-08-16 06:15:31.605066,Peelamedu,2,17,14,2,29,64,Moderate
2024-08-20 23:42:31.605066,Peelamedu,9,13,86,10,24,142,Moderate
2024-08-27 02:57:31.605066,Peelamedu,35,31,41,8,23,138,High
2024-08-08 13:49:31.605066,Peelamedu,26,3,73,11,14,127,Low
2024-08-30 02:20:31.605066,Peelamedu,31,21,45,10,9,116,High
2024-09-17 09:26:31.605066,Peelamedu,14,35,46,6,17,118,High
2024-09-09 01:54:31.605066,Peelamedu,27,47,136,3,14,227,Moderate
2024-09-20 04:49:31.605066,Peelamedu,55,37,127,17,15,251,High
2024-09-12 18:24:31.605066,Peelamedu,68,44,146,2,12,272,Moderate
2024-08-15 16:47:31.605066,Peelamedu,22,24,133,19,22,220,Moderate
2024-08-31 21:09:31.605066,Peelamedu,98,42,92,8,20,260,Moderate
2024-09-19 02:06:31.605066,Peelamedu,85,30,117,8,16,256,High
2024-09-08 13:16:31.605066,Peelamedu,34,44,98,7,9,192,Low
2024-09-10 15:38:31.605066,Peelamedu,23,31,57,0,10,121,Low
2024-08-21 03:27:31.605066,Peelamedu,6,14,113,10,3,146,Low
2024-08-11 08:12:31.605066,Peelamedu,24,39,71,5,2,141,Moderate
2024-09-25 20:11:31.605066,Peelamedu,38,30,57,8,18,151,High
2024-09-23 16:32:31.605066,Peelamedu,13,3,134,20,23,193,Moderate
2024-09-04 22:09:31.605066,Peelamedu,63,35,98,3,10,209,High
2024-07-27 15:40:31.605066,Peelamedu,56,9,121,7,12,205,Moderate
2024-09-16 00:21:31.605066,Peelamedu,84,21,124,20,5,254,Moderate
2024-08-04 00:30:31.605066,Peelamedu,29,46,147,8,15,245,Low
2024-09-21 23:59:31.605066,Peelamedu,98,32,21,2,4,157,Low
2024-09-10 19:27:31.605066,Peelamedu,85,48,20,16,24,193,High
2024-09-21 18:57:31.605066,Peelamedu,40,48,87,20,3,198,Low
2024-08-01 19:15:31.605066,Peelamedu,22,27,27,10,23,109,Moderate
2024-08-19 10:24:31.605066,Peelamedu,84,30,113,20,19,266,Low
2024-07-28 02:14:31.605066,Peelamedu,27,23,27,0,6,83,Moderate
2024-09-07 16:12:31.605066,Peelamedu,82,4,94,6,5,191,Low
2024-09-13 15:18:31.605066,Peelamedu,92,34,35,20,23,204,High
2024-08-18 13:41:31.605066,Peelamedu,74,25,118,15,16,248,Low
2024-09-14 02:15:31.605066,Peelamedu,79,7,121,17,4,228,High
2024-09-14 19:38:31.605066,Peelamedu,87,26,55,9,23,200,High
2024-08-12 23:40:31.605066,Peelamedu,3,4,78,15,5,105,Low
2024-08-02 16:44:31.605066,Peelamedu,22,7,33,18,28,108,Low
2024-08-28 00:13:31.605066,Peelamedu,77,24,145,13,25,284,High
2024-09-09 05:42:31.605066,Peelamedu,70,44,105,8,20,247,High
2024-08-22 09:15:31.605066,Peelamedu,63,49,4,19,20,155,Low
2024-09-24 18:23:31.605066,Peelamedu,77,25,76,11,1,190,Low
2024-09-07 23:40:31.605066,Peelamedu,95,31,89,1,6,222,High
2024-08-01 23:21:31.605066,Peelamedu,88,11,94,1,9,203,High
2024-09-18 23:36:31.605066,Peelamedu,14,48,112,8,13,195,Moderate
2024-08-24 17:17:31.605066,Peelamedu,87,15,82,1,24,209,High
2024-09-05 17:49:31.605066,Peelamedu,57,6,64,10,21,158,Moderate
2024-08-29 23:01:31.605066,Peelamedu,38,50,84,7,2,181,High
2024-08-28 14:17:31.605066,Peelamedu,58,41,35,14,30,178,Moderate
2024-08-24 11:19:31.605066,Peelamedu,13,2,8,11,19,53,Low
2024-09-10 07:47:31.605066,Peelamedu,85,29,140,5,9,268,High
2024-09-22 17:38:31.605066,Peelamedu,64,37,81,1,7,190,High
2024-07-27 16:15:31.605066,Peelamedu,17,33,21,11,28,110,Low
2024-09-11 02:46:31.605066,Peelamedu,81,42,35,13,17,188,Low
2024-09-23 07:14:31.605066,Peelamedu,44,4,113,7,18,186,Low
2024-09-07 09:02:31.605066,Peelamedu,30,17,120,16,7,190,Moderate
2024-08-29 01:07:31.605066,Peelamedu,10,21,98,17,29,175,Moderate
2024-08-29 18:02:31.605066,Peelamedu,67,31,6,14,29,147,Moderate
2024-09-11 04:56:31.605066,Peelamedu,90,11,150,4,12,267,Low
2024-08-16 07:06:31.605066,Peelamedu,77,49,148,10,3,287,Moderate
2024-08-16 05:31:31.605066,Peelamedu,0,30,56,6,7,99,Low
2024-09-03 00:04:31.605066,Peelamedu,32,48,23,2,7,112,High
2024-09-13 02:33:31.605066,Peelamedu,81,43,69,18,25,236,Moderate
2024-08-26 15:01:31.605066,Peelamedu,31,16,55,13,30,145,Moderate
2024-09-02 03:14:31.605066,Peelamedu,99,16,103,7,20,245,Moderate
2024-08-14 14:22:31.605066,Peelamedu,3,27,59,20,26,135,Moderate
2024-09-23 08:35:31.605066,Peelamedu,9,12,104,2,19,146,Moderate
2024-08-02 23:56:31.605066,Peelamedu,77,5,81,6,25,194,Moderate
2024-08-21 07:29:31.605066,Peelamedu,39,40,138,7,5,229,Moderate
2024-08-25 12:19:31.605066,Peelamedu,69,2,48,18,30,167,Low
2024-08-13 01:13:31.605066,Peelamedu,4,20,0,14,3,41,High
2024-09-20 02:00:31.605066,Peelamedu,97,49,145,19,2,312,Low
2024-08-31 18:44:31.605066,Peelamedu,4,32,117,7,7,167,High
2024-09-03 06:20:31.605066,Peelamedu,13,26,16,17,21,93,Moderate
2024-07-27 17:33:31.605066,Peelamedu,64,38,64,1,10,177,Low
2024-09-12 20:24:31.605066,Peelamedu,35,19,149,17,25,245,Low
2024-09-21 00:15:31.605066,Peelamedu,13,40,23,2,3,81,Moderate
2024-08-20 03:32:31.605066,Peelamedu,82,49,40,1,18,190,Moderate
2024-08-24 08:09:31.605066,Peelamedu,10,23,147,16,22,218,Moderate
2024-08-12 20:20:31.605066,Peelamedu,11,17,26,16,9,79,High
2024-08-05 14:41:31.605066,Peelamedu,40,11,44,0,19,114,Moderate
2024-09-17 16:57:31.605066,Peelamedu,51,5,112,14,22,204,Low
2024-09-22 22:52:31.605066,Peelamedu,72,16,121,15,18,242,Low
2024-08-03 07:35:31.605066,Peelamedu,33,28,42,16,23,142,Moderate
2024-08-16 08:20:31.605066,Peelamedu,82,21,50,12,17,182,High
2024-09-25 01:24:31.605066,Peelamedu,52,21,137,1,24,235,Moderate
2024-09-20 12:23:31.605066,Peelamedu,13,1,142,16,29,201,Moderate
2024-08-09 12:53:31.605066,Peelamedu,35,8,120,17,22,202,Moderate
2024-08-04 09:16:31.605066,Peelamedu,14,25,11,2,9,61,Low
2024-08-05 13:18:31.605066,Peelamedu,64,26,135,4,12,241,High
2024-08-04 01:18:31.605066,Peelamedu,38,43,128,9,3,221,Low
2024-09-19 20:21:31.605066,Peelamedu,21,34,15,15,11,96,Moderate
2024-07-30 15:33:31.605066,Peelamedu,69,33,60,10,21,193,Low
2024-09-07 15:42:31.605066,Peelamedu,2,23,63,3,30,121,Moderate
2024-09-03 17:06:31.605066,Peelamedu,44,10,46,3,19,122,Low
2024-08-17 20:38:31.605066,Peelamedu,92,12,15,4,11,134,Low
2024-07-31 00:30:31.605066,Peelamedu,82,28,31,15,21,177,Moderate
2024-08-09 14:15:31.605066,Peelamedu,14,18,133,15,4,184,Low
2024-08-17 09:58:31.605066,Peelamedu,93,29,52,20,1,195,High
2024-08-30 20:14:31.605066,Peelamedu,61,21,64,2,28,176,Moderate
2024-08-04 01:14:31.605066,Peelamedu,95,8,81,0,25,209,High
2024-09-12 01:19:31.605066,Peelamedu,13,27,102,9,18,169,Low
2024-09-24 13:49:31.605066,Peelamedu,21,30,64,4,19,138,Low
2024-08-16 07:53:31.605066,Peelamedu,26,28,135,8,5,202,High
2024-08-17 16:26:31.605066,Peelamedu,26,1,14,12,7,60,High
2024-09-08 19:57:31.605066,Peelamedu,56,10,5,13,21,105,High
2024-09-03 18:53:31.605066,Peelamedu,6,7,35,2,8,58,Low
2024-08-27 11:26:31.605066,Peelamedu,0,16,133,0,3,152,High
2024-08-18 03:59:31.605066,Peelamedu,100,45,3,10,25,183,Moderate
2024-09-17 16:59:31.605066,Peelamedu,16,8,96,13,26,159,High
2024-08-14 17:04:31.605066,Peelamedu,76,19,68,20,16,199,High
2024-09-26 08:11:31.605066,Peelamedu,59,50,47,15,2,173,Moderate
2024-08-03 15:18:31.605066,Peelamedu,66,45,12,16,5,144,Low
2024-09-08 18:36:31.605066,Peelamedu,45,45,118,5,30,243,Moderate
2024-09-22 23:49:31.605066,Peelamedu,30,9,88,4,19,150,High
2024-08-19 20:02:31.605066,Peelamedu,5,24,13,8,29,79,Low
2024-08-27 08:51:31.605066,Peelamedu,96,3,70,3,13,185,High
2024-08-23 11:04:31.605066,Peelamedu,79,6,40,3,17,145,High
2024-08-23 19:51:31.605066,Peelamedu,75,21,31,19,4,150,High
2024-08-21 23:22:31.605066,Peelamedu,90,20,147,14,17,288,Moderate
2024-09-18 05:28:31.605066,Peelamedu,33,10,87,6,27,163,Moderate
2024-09-15 12:05:31.605066,Peelamedu,51,5,116,6,1,179,High
2024-08-18 09:13:31.605066,Peelamedu,42,18,28,17,7,112,Low
2024-08-28 13:05:31.605066,Peelamedu,48,22,31,1,24,126,Moderate
2024-09-02 02:47:31.605066,Peelamedu,91,11,50,12,27,191,Low
2024-08-02 13:52:31.605066,Peelamedu,100,21,25,5,12,163,Low
2024-08-19 01:03:31.605066,Peelamedu,1,29,61,19,22,132,High
2024-08-26 03:23:31.605066,Peelamedu,5,16,1,6,30,58,Low
2024-08-15 15:25:31.605066,Peelamedu,35,35,77,6,26,179,High
2024-08-07 17:43:31.605066,Peelamedu,17,14,70,13,7,121,Moderate
2024-09-20 11:11:31.605066,Peelamedu,15,9,18,18,6,66,Low
2024-08-07 00:52:31.605066,Peelamedu,96,34,9,16,24,179,Low
2024-08-21 19:36:31.605066,Peelamedu,5,0,7,17,17,46,Low
2024-08-25 11:54:31.605066,Peelamedu,15,8,101,17,9,150,Low
2024-09-14 17:49:31.605066,Peelamedu,80,43,76,20,8,227,Low
2024-08-24 09:01:31.605066,Peelamedu,80,44,25,11,5,165,Moderate
2024-09-07 18:16:31.605066,Peelamedu,64,44,93,17,27,245,Moderate
2024-08-11 09:55:31.605066,Peelamedu,100,48,149,0,14,311,High
2024-09-16 13:07:31.605066,Peelamedu,14,25,114,7,27,187,High
2024-08-16 16:05:31.605066,Peelamedu,85,25,74,10,0,194,Moderate
2024-09-19 02:43:31.605066,Peelamedu,68,2,30,17,15,132,Low
2024-09-11 04:36:31.605066,Peelamedu,58,7,105,9,26,205,Moderate
2024-08-04 19:47:31.605066,Peelamedu,38,20,70,1,0,129,Low
2024-08-18 00:53:31.605066,Peelamedu,50,28,42,9,30,159,Low
2024-09-07 14:32:31.605066,Peelamedu,96,4,127,3,5,235,Moderate
2024-09-12 22:38:31.605066,Peelamedu,16,46,83,8,24,177,Moderate
2024-08-08 20:28:31.605066,Peelamedu,0,50,81,5,24,160,Moderate
2024-08-02 12:09:31.605066,Peelamedu,13,41,19,5,28,106,High
2024-09-05 03:15:31.605066,Peelamedu,0,26,43,11,6,86,Moderate
2024-09-13 03:04:31.605066,Peelamedu,51,32,133,2,16,234,High
2024-08-03 05:51:31.605066,Peelamedu,60,45,25,2,12,144,Moderate
2024-09-22 03:12:31.605066,Peelamedu,26,30,7,20,29,112,Moderate
2024-07-30 13:56:31.605066,Peelamedu,36,21,22,7,23,109,Moderate
2024-08-27 18:57:31.605066,Peelamedu,74,6,2,15,25,122,Moderate
2024-08-27 09:02:31.605066,Peelamedu,100,2,85,5,28,220,High
2024-08-31 03:12:31.605066,Peelamedu,80,20,6,19,24,149,Low
2024-09-18 02:22:31.605066,Peelamedu,100,32,145,12,20,309,Moderate
2024-09-04 09:52:31.605066,Peelamedu,74,6,30,14,7,131,Low
2024-09-12 21:09:31.605066,Peelamedu,72,46,16,2,28,164,Moderate
2024-09-11 08:04:31.605066,Peelamedu,63,42,98,19,7,229,Moderate
2024-08-28 05:30:31.605066,Peelamedu,58,8,31,12,4,113,Moderate
2024-08-09 12:06:31.605066,Peelamedu,38,23,25,18,9,113,High
2024-09-05 16:06:31.605066,Peelamedu,26,7,46,8,22,109,Low
2024-08-06 19:45:31.605066,Peelamedu,86,18,17,2,1,124,Moderate
2024-08-21 22:30:31.605066,Peelamedu,39,49,11,20,14,133,Low
2024-08-25 02:57:31.605066,Peelamedu,92,36,77,6,26,237,Moderate
2024-09-19 22:48:31.605066,Peelamedu,94,22,68,14,16,214,Moderate
2024-08-09 18:41:31.605066,Peelamedu,83,31,148,9,23,294,High
2024-08-04 11:38:31.605066,Peelamedu,95,29,69,15,28,236,High
2024-08-12 06:13:31.605066,Peelamedu,14,38,73,10,30,165,Moderate
2024-09-18 07:59:31.605066,Peelamedu,87,44,48,8,5,192,Moderate
2024-09-02 20:06:31.605066,Peelamedu,60,48,133,20,1,262,Moderate
2024-08-08 14:10:31.605066,Peelamedu,72,43,103,17,15,250,Moderate
2024-08-23 15:14:31.605066,Peelamedu,5,32,137,5,3,182,Low
2024-09-11 05:21:31.605066,Peelamedu,64,34,42,3,23,166,Moderate
2024-08-23 17:12:31.605066,Peelamedu,84,23,118,7,5,237,Moderate
2024-08-22 00:54:31.605066,Peelamedu,60,34,3,9,8,114,High
2024-09-16 08:04:31.605066,Peelamedu,40,0,44,7,3,94,High
2024-08-05 07:13:31.605066,Peelamedu,44,28,111,0,8,191,High
2024-08-06 00:55:31.605066,Peelamedu,56,15,65,7,13,156,High
2024-08-27 16:35:31.605066,Peelamedu,31,42,97,6,30,206,Moderate
2024-08-10 22:18:31.605066,Peelamedu,66,14,106,20,17,223,Low
2024-08-28 09:20:31.605066,Peelamedu,48,44,68,1,19,180,Moderate
2024-08-23 05:51:31.605066,Peelamedu,16,25,101,9,24,175,Moderate
2024-08-30 16:03:31.605066,Peelamedu,96,32,97,0,28,253,Moderate
2024-08-06 06:08:31.605066,Peelamedu,95,32,62,0,29,218,Moderate
2024-08-05 08:36:31.605066,Peelamedu,38,39,52,17,29,175,Low
2024-08-01 17:56:31.605066,Peelamedu,31,28,136,5,21,221,Moderate
2024-08-28 19:12:31.605066,Peelamedu,44,12,74,14,7,151,High
2024-09-07 10:41:31.605066,Peelamedu,92,47,43,16,5,203,Moderate
2024-09-12 08:34:31.605066,Peelamedu,17,13,134,7,17,188,Moderate
2024-08-25 18:57:31.605066,Peelamedu,83,27,109,16,15,250,High
2024-09-25 00:36:31.605066,Peelamedu,87,48,43,8,21,207,Moderate
2024-08-30 12:40:31.605066,Peelamedu,81,10,74,6,12,183,High
2024-08-29 08:34:31.605066,Peelamedu,96,41,142,2,22,303,Low
2024-08-03 01:56:31.605066,Peelamedu,25,1,127,3,5,161,Moderate
2024-09-17 02:59:31.605066,Peelamedu,37,39,71,17,21,185,Low
2024-09-08 18:35:31.605066,Peelamedu,71,36,101,18,22,248,High
2024-09-03 06:34:31.605066,Peelamedu,77,7,31,20,23,158,Low
2024-09-07 13:17:31.605066,Peelamedu,32,25,149,12,21,239,High
2024-09-04 02:10:31.605066,Peelamedu,34,25,51,4,0,114,Low
2024-08-01 21:11:31.605066,Peelamedu,13,50,16,16,22,117,Low
2024-09-04 12:34:31.605066,Peelamedu,61,20,110,8,0,199,High
2024-09-21 09:26:31.605066,Peelamedu,93,26,42,1,2,164,Moderate
2024-09-21 05:27:31.605066,Peelamedu,26,19,142,12,7,206,Low
2024-08-07 23:51:31.605066,Peelamedu,68,13,0,10,9,100,High
2024-08-24 20:36:31.605066,Peelamedu,93,40,119,0,19,271,High
2024-09-03 11:36:31.605066,Peelamedu,13,26,141,10,5,195,High
2024-09-21 18:11:31.605066,Peelamedu,86,42,130,17,23,298,Moderate
2024-07-28 09:38:31.605066,Peelamedu,96,11,7,18,15,147,Low
2024-09-12 16:14:31.605066,Peelamedu,90,37,19,13,10,169,High
2024-09-01 03:05:31.605066,Peelamedu,49,50,56,13,25,193,Low
2024-09-09 11:20:31.605066,Peelamedu,44,35,89,19,17,204,Moderate
2024-09-22 09:49:31.605066,Peelamedu,41,18,120,15,26,220,Moderate
2024-09-20 05:43:31.605066,Peelamedu,25,43,118,19,9,214,High
2024-08-28 19:25:31.605066,Peelamedu,48,6,87,10,25,176,Moderate
2024-09-02 20:29:31.605066,Peelamedu,12,43,42,7,12,116,High
2024-08-17 18:03:31.605066,Peelamedu,30,2,83,0,24,139,High
2024-09-08 07:27:31.605066,Peelamedu,23,48,73,2,29,175,Low
2024-08-07 08:15:31.605066,Peelamedu,1,17,117,19,19,173,Low
2024-07-27 16:00:31.605066,Peelamedu,83,15,69,5,24,196,High
2024-08-20 05:28:31.605066,Peelamedu,59,8,5,18,16,106,Moderate
2024-09-21 04:28:31.605066,Peelamedu,65,2,45,18,17,147,High
2024-08-04 20:38:31.605066,Peelamedu,58,29,38,13,12,150,Moderate
2024-08-20 18:21:31.605066,Peelamedu,90,31,22,19,20,182,High
2024-09-23 03:02:31.605066,Peelamedu,50,3,147,18,3,221,Low
2024-08-28 19:07:31.605066,Peelamedu,41,7,3,2,5,58,Low
2024-09-17 00:30:31.605066,Peelamedu,27,24,66,19,17,153,High
2024-09-06 07:09:31.605066,Peelamedu,74,21,108,11,26,240,Moderate
2024-09-23 15:49:31.605066,Peelamedu,7,23,5,16,12,63,Low
2024-08-26 15:47:31.605066,Peelamedu,49,39,50,3,28,169,Low
2024-09-07 23:37:31.605066,Peelamedu,23,12,74,19,30,158,Low
2024-07-27 16:48:31.605066,Peelamedu,52,39,97,2,6,196,High
2024-09-18 23:10:31.605066,Peelamedu,59,38,27,20,4,148,Low
2024-08-18 00:04:31.605066,Peelamedu,22,41,0,9,16,88,Low
2024-08-24 23:36:31.605066,Peelamedu,48,30,147,11,30,266,Low
2024-09-07 10:40:31.605066,Peelamedu,43,8,141,16,29,237,Low
2024-08-13 18:43:31.605066,Peelamedu,0,48,92,16,4,160,High
2024-09-06 09:30:31.605066,Peelamedu,75,30,120,20,11,256,Low
2024-08-18 13:28:31.605066,Peelamedu,1,18,86,15,22,142,Moderate
2024-09-06 10:27:31.605066,Peelamedu,8,4,77,16,21,126,Low
2024-08-07 09:24:31.605066,Peelamedu,100,15,86,1,15,217,Moderate
2024-08-15 14:15:31.605066,Peelamedu,50,2,109,5,9,175,Low
2024-08-08 08:32:31.605066,Peelamedu,25,35,113,1,26,200,Low
2024-09-18 09:51:31.605066,Peelamedu,71,9,57,10,21,168,Moderate
2024-09-07 11:19:31.605066,Peelamedu,23,41,56,20,12,152,High
2024-08-06 06:43:31.605066,Peelamedu,27,31,143,4,20,225,High
2024-08-26 06:11:31.605066,Peelamedu,33,8,128,13,20,202,Low
2024-09-18 14:51:31.605066,Peelamedu,51,19,33,10,22,135,High
2024-08-14 14:46:31.605066,Peelamedu,18,18,43,4,26,109,Low
2024-08-22 03:21:31.605066,Peelamedu,19,40,138,5,19,221,Moderate
2024-09-08 08:46:31.605066,Peelamedu,21,37,53,20,22,153,Low
2024-09-14 06:11:31.605066,Peelamedu,22,37,55,9,21,144,High
2024-09-16 14:11:31.605066,Peelamedu,88,41,45,6,1,181,High
2024-08-30 23:52:31.605066,Peelamedu,72,27,64,13,2,178,High
2024-09-14 09:53:31.605066,Peelamedu,19,16,101,2,2,140,Low
2024-08-14 11:00:31.605066,Peelamedu,29,2,14,8,18,71,Moderate
2024-09-02 10:17:31.605066,Peelamedu,84,29,112,19,24,268,Moderate
2024-09-03 18:39:31.605066,Peelamedu,42,29,145,0,1,217,Moderate
2024-08-13 02:26:31.605066,Peelamedu,61,23,141,20,24,269,Low
2024-08-13 16:59:31.605066,Peelamedu,50,24,7,14,2,97,Moderate
2024-08-06 12:36:31.605066,Peelamedu,23,2,40,0,29,94,Moderate
2024-08-17 01:33:31.605066,Peelamedu,58,24,72,4,14,172,Moderate
2024-08-19 13:19:31.605066,Peelamedu,11,16,124,12,1,164,High
2024-08-18 18:45:31.605066,Peelamedu,90,22,126,10,25,273,High
2024-08-08 19:04:31.605066,Peelamedu,44,24,50,14,14,146,Low
2024-08-02 01:33:31.605066,Peelamedu,18,4,130,8,15,175,High
2024-08-27 05:29:31.605066,Peelamedu,22,17,81,6,24,150,Low
2024-08-01 09:57:31.605066,Peelamedu,4,38,148,13,21,224,High
2024-09-15 23:35:31.605066,Peelamedu,71,8,10,16,12,117,Moderate
2024-07-28 05:54:31.605066,Peelamedu,96,15,126,13,3,253,Low
2024-08-19 15:49:31.605066,Peelamedu,37,6,80,2,12,137,Low
2024-08-23 20:12:31.605066,Peelamedu,49,44,92,0,23,208,Moderate
2024-08-28 23:02:31.605066,Peelamedu,60,10,147,17,9,243,Moderate
2024-09-19 06:52:31.605066,Peelamedu,53,24,96,8,16,197,High
2024-08-16 14:52:31.605066,Peelamedu,65,24,84,14,15,202,Moderate
2024-08-27 15:28:31.605066,Peelamedu,2,18,32,10,4,66,Moderate
2024-09-05 09:25:31.605066,Peelamedu,59,44,121,6,4,234,Low
2024-09-03 09:47:31.605066,Peelamedu,48,22,71,15,23,179,Low
2024-09-10 18:22:31.605066,Peelamedu,88,24,14,13,30,169,Low
2024-09-20 20:44:31.605066,Peelamedu,0,32,65,12,26,135,Moderate
2024-09-18 05:46:31.605066,Peelamedu,91,8,111,3,18,231,High
2024-08-16 02:54:31.605066,Peelamedu,2,43,77,19,4,145,Low
2024-09-23 06:53:31.605066,Peelamedu,89,34,34,8,28,193,Moderate
2024-09-04 06:03:31.605066,Peelamedu,44,44,1,14,21,124,High
2024-09-11 05:24:31.605066,Peelamedu,19,43,99,17,23,201,Low
2024-08-10 21:25:31.605066,Peelamedu,95,24,102,13,13,247,High
2024-09-07 00:27:31.605066,Peelamedu,30,34,24,5,18,111,Low
2024-09-25 19:38:31.605066,Peelamedu,100,6,38,19,10,173,High
2024-08-28 22:53:31.605066,Peelamedu,2,34,9,3,24,72,Moderate
2024-09-17 04:07:31.605066,Peelamedu,91,29,17,10,26,173,High
2024-08-22 23:39:31.605066,Peelamedu,44,44,148,10,20,266,Moderate
2024-09-20 16:40:31.605066,Peelamedu,71,45,82,4,8,210,Moderate
2024-09-20 17:10:31.605066,Peelamedu,89,48,40,15,1,193,Moderate
2024-07-28 04:26:31.605066,Peelamedu,52,31,86,19,17,205,Moderate
2024-08-19 12:05:31.605066,Peelamedu,54,46,102,2,22,226,Moderate
2024-08-18 01:13:31.605066,Peelamedu,17,23,113,19,4,176,Moderate
2024-08-26 01:09:31.605066,Peelamedu,8,5,75,10,4,102,Low
2024-08-25 09:32:31.605066,Peelamedu,84,0,147,15,5,251,High
2024-09-05 19:03:31.605066,Peelamedu,23,38,52,12,30,155,Low
2024-09-25 08:10:31.605066,Peelamedu,6,43,29,5,0,83,High
2024-07-28 00:16:31.605066,Peelamedu,61,24,138,8,1,232,Moderate
2024-09-22 11:07:31.605066,Peelamedu,16,45,88,6,19,174,Low
2024-08-14 08:56:31.605066,Peelamedu,61,6,119,13,28,227,Low
2024-09-05 19:27:31.605066,Peelamedu,63,22,106,10,27,228,Moderate
2024-09-16 05:23:31.605066,Peelamedu,58,35,31,7,21,152,Moderate
2024-09-07 07:32:31.605066,Peelamedu,60,19,81,9,17,186,High
2024-08-03 13:24:31.605066,Peelamedu,77,34,41,0,18,170,Low
2024-09-09 16:14:31.605066,Peelamedu,90,38,46,9,7,190,High
2024-09-14 16:12:31.605066,Peelamedu,33,20,143,13,16,225,High
2024-09-04 12:26:31.605066,Peelamedu,68,45,57,16,28,214,High
2024-09-23 00:52:31.605066,Peelamedu,1,20,99,8,30,158,Low
2024-09-22 13:28:31.605066,Peelamedu,59,48,40,8,14,169,Moderate
2024-08-19 08:57:31.605066,Peelamedu,43,43,148,12,9,255,Low
2024-08-11 18:38:31.605066,Peelamedu,48,32,69,10,4,163,Moderate
2024-09-15 22:12:31.605066,Peelamedu,53,38,111,20,5,227,Moderate
2024-09-04 20:01:31.605066,Peelamedu,4,15,122,3,14,158,Moderate
2024-07-30 11:46:31.605066,Peelamedu,1,3,135,4,20,163,Low
2024-08-19 08:36:31.605066,Peelamedu,19,33,143,9,10,214,Low
2024-08-01 08:47:31.605066,Peelamedu,53,6,1,18,26,104,Moderate
2024-09-08 09:18:31.605066,Peelamedu,44,21,9,11,0,85,High
2024-08-19 09:51:31.605066,Peelamedu,54,34,139,13,14,254,High
2024-08-22 21:21:31.605066,Peelamedu,44,28,110,7,6,195,High
2024-09-19 05:31:31.605066,Peelamedu,30,35,110,11,16,202,High
2024-08-21 03:33:31.605066,Peelamedu,28,23,19,8,9,87,Moderate
2024-09-14 00:14:31.605066,Peelamedu,61,46,86,20,19,232,High
2024-07-30 01:17:31.605066,Peelamedu,77,8,63,2,3,153,Moderate
2024-08-03 15:09:31.605066,Peelamedu,90,29,6,19,21,165,Moderate
2024-09-20 21:24:31.605066,Peelamedu,83,29,92,17,24,245,Moderate
2024-09-03 02:43:31.605066,Peelamedu,84,32,42,5,4,167,High
2024-07-30 00:26:31.605066,Peelamedu,40,19,85,16,7,167,High
2024-09-03 17:59:31.605066,Peelamedu,99,24,18,20,18,179,Moderate
2024-09-12 01:11:31.605066,Peelamedu,22,38,0,20,10,90,Low
2024-09-12 15:49:31.605066,Peelamedu,90,9,45,0,0,144,Moderate
2024-08-31 19:38:31.605066,Peelamedu,10,1,86,17,25,139,Moderate
2024-09-02 17:48:31.605066,Peelamedu,51,6,88,2,27,174,Moderate
2024-08-22 02:14:31.605066,Peelamedu,64,1,132,2,16,215,High
2024-08-12 05:52:31.605066,Peelamedu,70,12,65,9,29,185,Low
2024-08-02 10:35:31.605066,Peelamedu,11,38,24,11,26,110,High
2024-08-29 03:59:31.605066,Peelamedu,45,19,138,20,23,245,Low
2024-08-13 19:36:31.605066,Peelamedu,9,0,52,4,0,65,Low
2024-08-29 16:27:31.605066,Peelamedu,30,50,96,20,20,216,High
2024-07-29 06:45:31.605066,Peelamedu,43,19,37,15,28,142,Low
2024-08-11 04:31:31.605066,Peelamedu,35,12,4,14,4,69,Low
2024-09-10 00:02:31.605066,Peelamedu,69,37,63,11,0,180,Moderate
2024-07-27 20:46:31.605066,Peelamedu,48,36,74,8,28,194,Low
2024-07-29 22:26:31.605066,Peelamedu,81,49,29,10,5,174,Moderate
2024-08-11 05:18:31.605066,Peelamedu,41,31,89,20,6,187,Low
2024-09-06 20:24:31.605066,Peelamedu,60,5,23,16,10,114,Moderate
2024-08-27 22:29:31.605066,Peelamedu,35,8,5,16,11,75,Low
2024-08-16 21:58:31.605066,Peelamedu,87,6,132,12,2,239,Moderate
2024-09-14 04:59:31.605066,Peelamedu,39,31,103,19,25,217,Moderate
2024-09-19 19:26:31.605066,Peelamedu,84,27,48,14,28,201,Low
2024-09-21 08:44:31.605066,Peelamedu,66,1,145,15,9,236,Low
2024-09-11 21:03:31.605066,Peelamedu,26,19,71,17,29,162,Moderate
2024-07-28 18:41:31.605066,Peelamedu,76,20,19,11,3,129,Moderate
2024-08-25 00:06:31.605066,Peelamedu,66,27,20,6,10,129,High
2024-08-11 20:50:31.605066,Peelamedu,46,47,76,15,25,209,High
2024-09-16 05:56:31.605066,Peelamedu,9,17,60,11,3,100,Moderate
2024-08-08 19:45:31.605066,Peelamedu,49,39,64,14,14,180,High
2024-09-22 00:04:31.605066,Peelamedu,70,25,52,11,14,172,Moderate
2024-09-26 00:38:31.605066,Peelamedu,71,18,26,4,16,135,Moderate
2024-09-18 19:51:31.605066,Peelamedu,17,24,14,7,14,76,High
2024-09-10 02:10:31.605066,Peelamedu,60,32,17,3,9,121,Low
2024-09-02 10:12:31.605066,Peelamedu,97,17,27,17,24,182,Low
2024-08-19 16:29:31.605066,Peelamedu,98,19,136,6,30,289,Low
2024-09-17 17:05:31.605066,Peelamedu,27,3,42,8,23,103,Low
2024-08-09 16:58:31.605066,Peelamedu,29,10,128,7,4,178,High
2024-08-15 08:04:31.605066,Peelamedu,30,2,49,0,7,88,Moderate
2024-08-18 03:21:31.605066,Peelamedu,89,48,75,13,27,252,High
2024-09-20 21:14:31.605066,Peelamedu,15,40,98,12,17,182,Moderate
2024-08-17 03:32:31.605066,Peelamedu,26,35,142,8,23,234,Low
2024-07-27 20:21:31.605066,Peelamedu,25,22,47,3,19,116,High
2024-08-10 04:46:31.605066,Peelamedu,15,35,99,12,20,181,Moderate
2024-09-19 05:52:31.605066,Peelamedu,53,34,1,10,24,122,Moderate
2024-09-07 16:33:31.605066,Peelamedu,68,36,111,9,20,244,Moderate
2024-08-23 14:53:31.605066,Peelamedu,12,5,119,6,11,153,Low
2024-08-11 08:56:31.605066,Peelamedu,24,13,98,1,16,152,Moderate
2024-09-15 10:03:31.605066,Peelamedu,5,39,148,8,18,218,High
2024-08-22 17:58:31.605066,Peelamedu,8,30,91,14,12,155,High
2024-09-18 21:32:31.605066,Peelamedu,4,31,5,7,30,77,Moderate
2024-08-11 02:42:31.605066,Peelamedu,67,41,47,12,13,180,High
2024-08-27 18:57:31.605066,Peelamedu,58,44,33,14,15,164,Moderate
2024-07-29 22:31:31.605066,Peelamedu,33,15,21,9,1,79,Low
2024-08-23 22:16:31.605066,Peelamedu,92,36,106,10,25,269,Moderate
2024-08-16 12:59:31.605066,Peelamedu,33,29,17,9,13,101,High
2024-09-11 22:04:31.605066,Peelamedu,21,6,71,12,26,136,Moderate
2024-08-14 22:32:31.605066,Peelamedu,15,27,63,12,28,145,Moderate
2024-08-31 13:08:31.605066,Peelamedu,47,13,18,10,22,110,Low
2024-09-17 17:59:31.605066,Peelamedu,85,16,139,20,6,266,Low
2024-09-23 16:21:31.605066,Peelamedu,61,17,4,11,18,111,Moderate
2024-09-03 15:50:31.605066,Peelamedu,30,24,110,17,20,201,Low
2024-08-21 01:01:31.605066,Peelamedu,76,21,53,8,8,166,Low
2024-09-05 15:56:31.605066,Peelamedu,100,19,117,13,27,276,Low
2024-09-03 11:41:31.605066,Peelamedu,79,18,47,19,10,173,High
2024-07-27 14:55:31.605066,Peelamedu,39,8,20,16,25,108,Low
2024-08-10 09:17:31.605066,Peelamedu,75,27,16,11,29,158,High
2024-09-09 13:59:31.605066,Peelamedu,86,7,117,3,18,231,Moderate
2024-09-13 21:35:31.605066,Peelamedu,42,15,18,15,14,104,High
2024-09-18 06:09:31.605066,Peelamedu,23,12,113,0,2,150,Low
2024-08-15 06:25:31.605066,Peelamedu,53,21,10,5,16,105,High
2024-08-21 22:43:31.605066,Peelamedu,68,34,116,1,29,248,Moderate
2024-08-28 23:41:31.605066,Peelamedu,98,20,110,2,29,259,High
2024-08-14 12:02:31.605066,Peelamedu,77,10,40,17,12,156,Moderate
2024-09-08 21:27:31.605066,Peelamedu,88,32,9,17,13,159,High
2024-09-02 10:00:31.605066,Peelamedu,18,18,56,19,10,121,Low
2024-09-20 02:11:31.605066,Peelamedu,27,18,142,1,20,208,Moderate
2024-09-18 03:03:31.605066,Peelamedu,91,3,61,13,22,190,High
2024-08-01 22:43:31.605066,Peelamedu,96,22,18,20,28,184,High
2024-07-30 01:16:31.605066,Peelamedu,50,45,69,14,12,190,Low
2024-08-12 22:10:31.605066,Peelamedu,3,24,20,15,14,76,Low
2024-07-31 04:09:31.605066,Peelamedu,95,41,64,4,30,234,High
2024-08-15 12:35:31.605066,Peelamedu,4,44,137,2,7,194,Low
2024-09-18 04:25:31.605066,Peelamedu,57,24,62,14,26,183,High
2024-09-11 18:35:31.605066,Peelamedu,17,21,37,11,6,92,High
2024-08-10 07:35:31.605066,Peelamedu,38,13,8,12,17,88,Moderate
2024-08-05 23:17:31.605066,Peelamedu,62,22,123,19,7,233,High
2024-09-04 08:39:31.605066,Peelamedu,85,17,126,11,22,261,Moderate
2024-09-01 08:50:31.605066,Peelamedu,31,7,149,1,4,192,High
2024-08-25 17:36:31.605066,Peelamedu,39,5,115,20,7,186,Moderate
2024-08-24 00:48:31.605066,Peelamedu,90,31,77,8,6,212,Low
2024-09-21 14:52:31.605066,Peelamedu,16,42,26,8,24,116,Low
2024-08-26 17:06:31.605066,Peelamedu,17,19,143,20,18,217,Low
2024-09-25 00:10:31.605066,Peelamedu,80,24,32,0,30,166,Moderate
2024-09-15 13:05:31.605066,Peelamedu,90,2,147,0,12,251,High
2024-08-28 22:40:31.605066,Peelamedu,31,32,22,8,6,99,Moderate
2024-09-15 03:41:31.605066,Peelamedu,39,34,64,0,27,164,High
2024-08-31 08:13:31.605066,Peelamedu,95,46,103,19,21,284,Low
2024-09-01 22:57:31.605066,Peelamedu,15,32,18,5,8,78,High
2024-08-18 12:02:31.605066,Peelamedu,96,36,129,5,6,272,High
2024-08-22 08:19:31.605066,Peelamedu,55,16,149,0,17,237,Low
2024-09-09 22:33:31.605066,Peelamedu,18,13,112,9,0,152,Moderate
2024-09-18 19:36:31.605066,Peelamedu,73,8,28,14,2,125,Moderate
2024-09-19 05:02:31.605066,Peelamedu,20,5,142,13,16,196,High
2024-09-24 12:32:31.605066,Peelamedu,22,4,51,17,9,103,Low
2024-09-01 21:48:31.605066,Peelamedu,37,32,19,6,25,119,Low
2024-08-17 07:25:31.605066,Peelamedu,80,23,84,12,13,212,High
2024-08-01 14:40:31.605066,Peelamedu,52,24,97,15,16,204,Moderate
2024-07-31 23:54:31.605066,Peelamedu,50,8,32,9,15,114,High
2024-08-18 13:46:31.605066,Peelamedu,45,9,84,3,9,150,Moderate
2024-09-22 15:26:31.605066,Peelamedu,93,3,71,10,8,185,High
2024-08-27 01:12:31.605066,Peelamedu,43,22,6,17,6,94,Low
2024-08-16 20:29:31.605066,Peelamedu,62,20,112,9,19,222,High
2024-08-05 19:04:31.605066,Peelamedu,8,47,6,1,5,67,Moderate
2024-09-03 04:45:31.605066,Peelamedu,18,7,36,1,10,72,Low
2024-09-02 08:28:31.605066,Peelamedu,30,4,138,3,11,186,Low
2024-07-29 22:04:31.605066,Peelamedu,96,15,23,11,28,173,Moderate
2024-08-04 14:04:31.605066,Peelamedu,37,47,37,16,9,146,Low
2024-08-23 20:57:31.605066,Peelamedu,47,13,100,19,1,180,Moderate
2024-08-22 20:36:31.605066,Peelamedu,82,29,21,8,17,157,Moderate
2024-08-21 04:19:31.605066,Peelamedu,44,25,47,17,23,156,Moderate
2024-08-29 16:03:31.605066,Peelamedu,4,16,124,6,27,177,Low
2024-08-28 21:10:31.605066,Peelamedu,25,27,6,19,16,93,High
2024-09-17 08:10:31.605066,Peelamedu,6,48,141,19,17,231,Low
2024-09-17 00:18:31.605066,Peelamedu,55,28,143,19,7,252,Moderate
2024-07-28 23:49:31.605066,Peelamedu,40,23,101,19,8,191,High
2024-08-26 16:25:31.605066,Peelamedu,81,46,143,13,2,285,High
2024-09-17 16:11:31.605066,Peelamedu,8,16,2,2,20,48,Low
2024-09-07 06:30:31.605066,Peelamedu,93,32,79,0,12,216,Moderate
2024-09-13 11:21:31.605066,Peelamedu,63,37,50,4,2,156,Low
2024-08-03 01:54:31.605066,Peelamedu,31,33,92,20,10,186,Low
2024-08-26 14:13:31.605066,Peelamedu,50,19,30,1,20,120,High
2024-09-07 17:27:31.605066,Peelamedu,11,6,21,16,3,57,High
2024-09-22 03:34:31.605066,Peelamedu,52,42,22,7,24,147,High
2024-08-28 23:39:31.605066,Peelamedu,11,42,14,16,2,85,Moderate
2024-08-08 07:04:31.605066,Peelamedu,70,10,33,4,14,131,High
2024-08-08 05:06:31.605066,Peelamedu,18,43,66,0,23,150,Moderate
2024-08-10 04:27:31.605066,Peelamedu,72,32,41,9,7,161,Moderate
2024-08-07 00:11:31.605066,Peelamedu,57,8,101,6,8,180,High
2024-09-12 08:17:31.605066,Peelamedu,8,31,125,10,18,192,High
2024-08-06 06:43:31.605066,Peelamedu,67,5,75,6,12,165,High
2024-09-12 10:08:31.605066,Peelamedu,36,25,113,8,4,186,High
2024-09-11 20:05:31.605066,Peelamedu,60,17,40,13,26,156,High
2024-08-29 23:13:31.605066,Peelamedu,61,41,125,10,15,252,Moderate
2024-08-02 06:40:31.605066,Peelamedu,67,30,70,11,3,181,High
2024-08-06 21:25:31.605066,Peelamedu,85,33,17,14,16,165,High
2024-08-22 22:33:31.605066,Peelamedu,22,15,35,14,25,111,High
2024-09-15 06:14:31.605066,Peelamedu,95,33,23,9,27,187,Moderate
2024-07-29 04:07:31.605066,Peelamedu,48,34,6,0,17,105,High
2024-08-18 02:47:31.605066,Peelamedu,50,15,6,9,10,90,High
2024-08-08 03:50:31.605066,Peelamedu,17,21,27,2,4,71,Moderate
2024-09-26 03:53:31.605066,Peelamedu,61,42,19,13,0,135,Moderate
2024-08-02 17:01:31.605066,Peelamedu,35,38,82,12,15,182,Low
2024-08-31 18:27:31.605066,Peelamedu,95,14,150,12,24,295,High
2024-08-02 07:22:31.605066,Peelamedu,27,14,148,4,10,203,High
2024-08-19 15:23:31.605066,Peelamedu,25,41,115,20,13,214,High
2024-09-16 14:21:31.605066,Peelamedu,49,36,64,12,0,161,High
2024-08-25 04:08:31.605066,Peelamedu,40,13,6,15,9,83,Low
2024-08-02 06:56:31.605066,Peelamedu,43,11,115,14,12,195,Moderate
2024-09-09 14:42:31.605066,Peelamedu,30,27,88,9,6,160,Low
2024-09-22 03:18:31.605066,Peelamedu,37,42,72,18,0,169,Moderate
2024-09-25 04:46:31.605066,Peelamedu,78,28,17,8,13,144,High
2024-08-29 07:40:31.605066,Peelamedu,80,26,5,1,23,135,Low
2024-08-29 00:33:31.605066,Peelamedu,69,39,61,20,5,194,Low
2024-07-27 15:55:31.605066,Peelamedu,21,35,107,15,1,179,High
2024-08-23 01:10:31.605066,Peelamedu,36,45,89,15,2,187,Moderate
2024-09-16 10:43:31.605066,Peelamedu,45,42,44,15,2,148,High
2024-08-15 05:51:31.605066,Peelamedu,82,31,51,9,20,193,Moderate
2024-09-16 11:31:31.605066,Peelamedu,87,26,88,13,28,242,Low
2024-08-14 04:43:31.605066,Peelamedu,100,32,97,4,9,242,High
2024-09-07 23:06:31.605066,Peelamedu,58,45,75,10,19,207,High
2024-08-27 18:48:31.605066,Peelamedu,74,20,12,9,22,137,High
2024-08-10 17:06:31.605066,Peelamedu,35,24,40,18,11,128,High
2024-07-28 19:51:31.605066,Peelamedu,92,2,21,6,23,144,High
2024-08-14 11:08:31.605066,Peelamedu,54,9,8,3,27,101,Low
2024-09-19 07:44:31.605066,Peelamedu,56,11,35,9,10,121,Low
2024-08-10 01:20:31.605066,Peelamedu,83,23,62,17,12,197,Low
2024-09-06 17:41:31.605066,Peelamedu,80,26,98,14,20,238,Low
2024-09-02 09:02:31.605066,Peelamedu,10,39,150,11,24,234,Moderate
2024-09-09 00:34:31.605066,Peelamedu,8,37,139,5,30,219,Low
2024-09-08 10:26:31.605066,Peelamedu,83,7,22,16,14,142,Low
2024-08-07 19:22:31.605066,Peelamedu,62,37,89,4,19,211,Low
2024-08-22 03:37:31.605066,Peelamedu,1,6,97,2,25,131,Low
2024-08-31 20:31:31.605066,Peelamedu,87,0,10,9,15,121,High
2024-09-02 05:02:31.605066,Peelamedu,82,34,126,9,19,270,Low
2024-08-13 11:29:31.605066,Peelamedu,75,31,12,1,0,119,Moderate
2024-09-02 16:02:31.605066,Peelamedu,88,29,75,10,1,203,High
2024-08-10 00:29:31.605066,Peelamedu,9,48,101,12,25,195,Low
2024-08-22 22:15:31.605066,Peelamedu,46,32,69,19,10,176,High
2024-09-08 22:37:31.605066,Peelamedu,99,36,33,10,7,185,Moderate
2024-08-21 05:46:31.605066,Peelamedu,86,38,130,1,16,271,Moderate
2024-08-05 13:43:31.605066,Peelamedu,2,16,49,17,30,114,Moderate
2024-09-24 20:46:31.605066,Peelamedu,8,23,15,4,28,78,Moderate
2024-09-14 14:04:31.605066,Peelamedu,31,12,61,2,1,107,High
2024-07-29 11:56:31.605066,Peelamedu,39,2,140,20,3,204,Moderate
2024-08-09 15:06:31.605066,Peelamedu,22,32,8,18,1,81,Low
2024-08-28 13:06:31.605066,Peelamedu,68,4,86,8,4,170,Moderate
2024-08-14 04:49:31.605066,Peelamedu,87,11,85,14,13,210,Low
2024-07-30 11:36:31.605066,Peelamedu,61,49,128,7,1,246,Low
2024-08-21 12:23:31.605066,Peelamedu,100,38,129,10,30,307,Moderate
2024-08-21 00:23:31.605066,Peelamedu,60,8,120,20,4,212,Low
2024-09-08 04:10:31.605066,Peelamedu,25,3,54,17,22,121,High
2024-08-10 13:24:31.605066,Peelamedu,56,47,31,5,30,169,Low
2024-09-19 03:33:31.605066,Peelamedu,20,5,125,12,6,168,High
2024-09-10 00:49:31.605066,Peelamedu,48,25,69,16,25,183,Low
2024-07-31 04:12:31.605066,Peelamedu,4,24,37,12,24,101,High
2024-09-02 08:16:31.605066,Peelamedu,85,35,71,13,4,208,Moderate
2024-07-30 16:48:31.605066,Peelamedu,16,33,11,8,16,84,High
2024-08-18 22:31:31.605066,Peelamedu,81,31,64,9,25,210,High
2024-08-29 09:31:31.605066,Peelamedu,98,1,19,9,0,127,Moderate
2024-08-28 14:24:31.605066,Peelamedu,6,32,107,19,29,193,High
2024-09-20 02:32:31.605066,Peelamedu,90,33,10,0,5,138,High
2024-08-29 17:09:31.605066,Peelamedu,36,49,107,9,23,224,Moderate
2024-09-12 13:10:31.605066,Peelamedu,68,40,136,20,4,268,High
2024-08-02 03:03:31.605066,Peelamedu,22,31,103,16,7,179,High
2024-08-13 02:02:31.605066,Peelamedu,12,13,45,7,22,99,Moderate
2024-09-09 04:33:31.605066,Peelamedu,0,15,90,17,13,135,High
2024-08-31 22:48:31.605066,Peelamedu,11,42,2,8,19,82,High
2024-08-06 17:52:31.605066,Peelamedu,68,9,142,10,22,251,High
2024-08-02 23:16:31.605066,Peelamedu,78,42,95,18,11,244,Moderate
2024-08-10 22:01:31.605066,Peelamedu,35,29,41,9,18,132,Low
2024-08-24 22:50:31.605066,Peelamedu,86,36,135,11,5,273,Low
2024-09-08 16:13:31.605066,Peelamedu,93,20,82,20,5,220,Low
2024-08-20 10:03:31.605066,Peelamedu,54,26,38,9,4,131,Moderate
2024-08-30 22:23:31.605066,Peelamedu,58,45,71,19,0,193,Low
2024-08-18 13:44:31.605066,Peelamedu,2,49,92,10,24,177,Low
2024-08-27 05:23:31.605066,Peelamedu,91,34,36,9,13,183,Low
2024-07-31 22:18:31.605066,Peelamedu,17,36,0,3,19,75,Low
2024-08-13 14:14:31.605066,Peelamedu,64,9,64,14,30,181,Low
2024-09-08 02:56:31.605066,Peelamedu,41,47,103,18,8,217,Low
2024-09-23 21:47:31.605066,Peelamedu,48,16,5,19,9,97,Low
2024-08-15 12:45:31.605066,Peelamedu,61,19,60,19,5,164,Low
2024-09-23 12:22:31.605066,Peelamedu,71,14,32,3,6,126,High
2024-08-11 04:18:31.605066,Peelamedu,50,14,93,3,20,180,High
2024-08-25 11:57:31.605066,Peelamedu,31,39,116,7,20,213,Low
2024-09-06 23:04:31.605066,Peelamedu,76,36,59,8,23,202,High
2024-09-13 15:26:31.605066,Peelamedu,37,16,42,6,4,105,High
2024-08-02 14:24:31.605066,Peelamedu,52,33,13,19,18,135,Moderate
2024-08-08 20:04:31.605066,Peelamedu,22,16,127,18,10,193,Moderate
2024-08-11 04:33:31.605066,Peelamedu,62,12,108,9,12,203,Low
2024-08-01 01:59:31.605066,Peelamedu,34,49,104,9,10,206,Low
2024-09-07 20:34:31.605066,Peelamedu,50,50,129,19,13,261,High
2024-08-11 03:44:31.605066,Peelamedu,9,41,95,16,2,163,Moderate
2024-08-29 10:48:31.605066,Peelamedu,86,7,61,9,9,172,High
2024-07-31 15:41:31.605066,Peelamedu,21,23,1,16,10,71,Low
2024-08-22 13:48:31.605066,Peelamedu,57,7,115,7,21,207,Low
2024-08-15 23:11:31.605066,Peelamedu,6,39,124,18,24,211,Moderate
2024-08-21 13:48:31.605066,Peelamedu,7,22,105,4,26,164,Low
2024-08-03 23:36:31.605066,Peelamedu,38,40,18,20,11,127,Moderate
2024-08-23 06:05:31.605066,Peelamedu,2,6,26,1,17,52,High
2024-08-19 16:40:31.605066,Peelamedu,78,24,7,6,5,120,High
2024-08-13 08:12:31.605066,Peelamedu,49,32,22,14,1,118,Moderate
2024-08-18 23:34:31.605066,Peelamedu,92,39,134,7,26,298,Low
2024-08-13 14:16:31.605066,Peelamedu,84,18,149,4,24,279,Moderate
2024-08-02 20:53:31.605066,Peelamedu,68,16,7,12,16,119,High
2024-08-19 14:33:31.605066,Peelamedu,39,6,46,15,11,117,Moderate
2024-07-31 12:54:31.605066,Peelamedu,47,21,16,12,17,113,Low
2024-07-31 09:02:31.605066,Peelamedu,26,6,10,11,5,58,Low
2024-09-09 02:36:31.605066,Peelamedu,62,21,4,13,0,100,High
2024-07-28 22:04:31.605066,Peelamedu,51,4,53,0,16,124,Low
2024-09-09 01:09:31.605066,Peelamedu,94,24,129,7,24,278,Moderate
2024-08-25 13:42:31.605066,Peelamedu,39,7,134,0,6,186,Moderate
2024-09-02 14:31:31.605066,Peelamedu,6,4,40,12,24,86,High
2024-07-30 01:02:31.605066,Peelamedu,44,9,46,12,30,141,Low
2024-09-15 08:16:31.605066,Peelamedu,55,35,77,10,1,178,High
2024-08-04 03:03:31.605066,Peelamedu,8,48,64,10,21,151,Moderate
2024-09-04 17:30:31.605066,Peelamedu,70,49,131,5,1,256,High
2024-08-25 12:29:31.605066,Peelamedu,60,1,144,15,29,249,High
2024-08-29 21:44:31.605066,Peelamedu,32,20,43,10,3,108,Low
2024-08-12 20:40:31.605066,Peelamedu,74,46,27,18,16,181,Moderate
2024-08-08 01:18:31.605066,Peelamedu,62,33,44,3,23,165,Moderate
2024-08-12 09:37:31.605066,Peelamedu,83,41,127,0,12,263,High
2024-09-08 09:22:31.605066,Peelamedu,13,33,33,4,20,103,Low
2024-09-14 14:23:31.605066,Peelamedu,16,35,37,17,30,135,Moderate
2024-08-03 17:02:31.605066,Peelamedu,41,40,114,7,22,224,Low
2024-08-01 14:44:31.605066,Peelamedu,9,43,4,3,5,64,Moderate
2024-07-27 16:49:31.605066,Peelamedu,39,15,47,0,26,127,Low
2024-08-28 09:45:31.605066,Peelamedu,4,10,45,19,23,101,Low
2024-08-27 00:07:31.605066,Peelamedu,80,36,55,11,7,189,Low
2024-09-08 00:17:31.605066,Peelamedu,73,15,115,15,20,238,Low
2024-08-11 06:15:31.605066,Peelamedu,7,34,92,14,15,162,High
2024-08-29 16:24:31.605066,Peelamedu,14,32,85,17,29,177,High
2024-08-31 23:25:31.605066,Peelamedu,18,47,23,12,25,125,High
2024-09-10 13:36:31.605066,Peelamedu,36,32,93,13,6,180,Low
2024-08-28 23:48:31.605066,Peelamedu,73,26,109,7,0,215,Low
2024-09-22 22:35:31.605066,Peelamedu,36,13,6,15,4,74,Moderate
2024-09-13 18:32:31.605066,Peelamedu,25,49,121,16,10,221,Moderate
2024-08-18 08:06:31.605066,Peelamedu,25,4,11,9,10,59,High
2024-09-14 04:30:31.605066,Peelamedu,48,3,130,12,25,218,High
2024-09-05 11:01:31.605066,Peelamedu,92,3,115,9,18,237,Moderate
2024-09-06 23:55:31.605066,Peelamedu,49,30,139,10,18,246,Moderate
2024-08-04 20:03:31.605066,Peelamedu,48,45,95,11,10,209,High
2024-09-26 02:07:31.605066,Peelamedu,41,15,18,6,18,98,Moderate
2024-08-04 02:52:31.605066,Peelamedu,88,22,10,6,1,127,High
2024-08-01 14:33:31.605066,Peelamedu,53,1,90,20,0,164,Low
2024-08-17 19:00:31.605066,Peelamedu,89,40,41,13,12,195,High
2024-09-01 17:05:31.605066,Peelamedu,34,41,33,6,27,141,High
2024-09-25 06:00:31.605066,Peelamedu,4,44,92,4,30,174,Low
2024-08-28 19:44:31.605066,Peelamedu,58,4,27,14,4,107,Moderate
2024-08-14 03:12:31.605066,Peelamedu,63,40,117,15,6,241,Low
2024-08-08 02:06:31.605066,Peelamedu,6,16,94,7,15,138,Low
2024-09-14 06:06:31.605066,Peelamedu,75,33,135,17,27,287,Moderate
2024-08-12 05:23:31.605066,Peelamedu,75,37,146,17,19,294,Low
2024-08-28 18:14:31.605066,Peelamedu,79,5,74,3,25,186,High
2024-08-29 18:19:31.605066,Peelamedu,79,19,116,8,30,252,Moderate
2024-08-22 12:00:31.605066,Peelamedu,93,15,17,8,22,155,Low
2024-08-11 05:25:31.605066,Peelamedu,12,6,145,5,10,178,Moderate
2024-07-27 15:28:31.605066,Peelamedu,70,24,13,9,5,121,Moderate
2024-08-25 02:06:31.605066,Peelamedu,76,26,69,6,21,198,Low
2024-08-26 00:40:31.605066,Peelamedu,72,23,84,4,20,203,High
2024-09-14 05:13:31.605066,Peelamedu,18,24,74,10,19,145,High
2024-08-26 11:07:31.605066,Peelamedu,62,31,5,7,22,127,Moderate
2024-09-11 01:08:31.605066,Peelamedu,33,25,83,1,22,164,Low
2024-08-01 04:34:31.605066,Peelamedu,33,2,27,8,19,89,Moderate
2024-09-05 16:34:31.605066,Peelamedu,4,41,131,13,15,204,High
2024-09-17 00:21:31.605066,Peelamedu,76,23,82,14,10,205,Moderate
2024-08-13 15:40:31.605066,Peelamedu,43,50,78,14,16,201,Moderate
2024-08-20 11:09:31.605066,Peelamedu,1,46,55,9,2,113,High
2024-07-31 20:55:31.605066,Peelamedu,58,43,97,15,26,239,Moderate
2024-08-05 22:16:31.605066,Peelamedu,0,13,38,10,23,84,Low
2024-09-11 17:03:31.605066,Peelamedu,13,2,44,20,8,87,Low
2024-09-12 19:41:31.605066,Peelamedu,17,19,43,11,15,105,Low
2024-08-27 03:52:31.605066,Peelamedu,23,15,86,2,29,155,High
2024-08-12 07:33:31.605066,Peelamedu,71,36,145,6,5,263,High
2024-09-25 12:56:31.605066,Peelamedu,92,24,55,10,17,198,Low
2024-07-31 18:55:31.605066,Peelamedu,12,29,80,20,14,155,High
2024-08-14 19:45:31.605066,Peelamedu,59,41,70,20,0,190,Moderate
2024-08-21 22:23:31.605066,Peelamedu,86,47,15,20,10,178,Low
2024-08-17 11:18:31.605066,Peelamedu,52,21,134,5,17,229,Moderate
2024-09-13 19:51:31.605066,Peelamedu,75,18,113,0,0,206,Low
2024-08-10 12:00:31.605066,Peelamedu,45,43,109,20,5,222,High
2024-09-19 02:23:31.605066,Peelamedu,50,28,24,3,26,131,High
2024-09-02 07:06:31.605066,Peelamedu,99,15,69,7,10,200,High
2024-08-03 01:28:31.605066,Peelamedu,11,43,1,1,10,66,Moderate
2024-08-19 10:43:31.605066,Peelamedu,43,4,68,7,4,126,Low
2024-08-17 19:16:31.605066,Peelamedu,36,41,36,18,15,146,Low
2024-08-25 22:37:31.605066,Peelamedu,85,29,9,12,11,146,Low
2024-08-28 22:00:31.605066,Peelamedu,23,22,130,15,29,219,Moderate
2024-09-22 14:20:31.605066,Peelamedu,75,34,136,3,26,274,Moderate
2024-08-06 17:23:31.605066,Peelamedu,68,2,82,15,17,184,Moderate
2024-08-24 02:29:31.605066,Peelamedu,89,48,44,8,27,216,High
2024-09-12 21:23:31.605066,Peelamedu,76,0,84,8,22,190,Moderate
2024-08-02 05:06:31.605066,Peelamedu,7,42,75,9,26,159,High
2024-08-29 14:21:31.605066,Peelamedu,88,15,66,11,22,202,Moderate
2024-09-01 21:54:31.605066,Peelamedu,64,17,52,0,29,162,Low
2024-09-08 17:45:31.605066,Peelamedu,49,17,13,11,0,90,Low
2024-09-12 21:06:31.605066,Peelamedu,16,32,56,7,18,129,High
2024-09-12 17:15:31.605066,Peelamedu,22,12,41,17,7,99,Moderate
2024-09-11 18:56:31.605066,Peelamedu,23,42,18,8,2,93,Low
2024-07-29 08:41:31.605066,Peelamedu,0,23,129,7,4,163,Low
2024-09-20 09:33:31.605066,Peelamedu,46,28,45,11,23,153,High
2024-09-18 22:13:31.605066,Peelamedu,40,17,149,5,26,237,Moderate
2024-07-30 13:42:31.605066,Peelamedu,36,6,21,6,26,95,High
2024-08-20 01:13:31.605066,Peelamedu,16,50,30,13,0,109,Moderate
2024-09-03 06:17:31.605066,Peelamedu,28,39,109,11,19,206,Low
2024-08-18 08:14:31.605066,Peelamedu,39,45,81,18,30,213,High
2024-09-07 01:26:31.605066,Peelamedu,57,13,95,6,17,188,Moderate
2024-09-24 15:16:31.605066,Peelamedu,47,11,29,10,10,107,Moderate
2024-09-25 01:23:31.605066,Peelamedu,79,39,24,17,18,177,Moderate
2024-08-17 06:20:31.605066,Peelamedu,25,12,127,10,11,185,Low
2024-08-03 22:50:31.605066,Peelamedu,34,23,84,13,10,164,Moderate
2024-08-23 04:37:31.605066,Peelamedu,88,19,20,17,13,157,Low
2024-08-09 08:57:31.605066,Peelamedu,24,45,76,20,17,182,High
2024-08-02 17:46:31.605066,Peelamedu,2,23,100,18,7,150,High
2024-09-05 06:46:31.605066,Peelamedu,41,22,104,18,12,197,Moderate
2024-08-01 16:10:31.605066,Peelamedu,85,1,135,8,17,246,High
2024-08-16 04:43:31.605066,Peelamedu,11,11,120,11,9,162,High
2024-09-18 01:32:31.605066,Peelamedu,61,36,53,12,16,178,Moderate
2024-09-16 12:09:31.605066,Peelamedu,4,18,66,4,0,92,Low
2024-08-28 11:49:31.605066,Peelamedu,50,15,113,1,22,201,High
2024-08-07 15:25:31.605066,Peelamedu,71,47,5,14,20,157,Low
2024-09-20 13:35:31.605066,Peelamedu,5,39,45,4,5,98,Moderate
2024-09-20 14:21:31.605066,Peelamedu,63,45,11,17,9,145,Moderate
2024-08-03 03:01:31.605066,Peelamedu,92,35,3,2,23,155,Moderate
2024-08-17 13:51:31.605066,Peelamedu,24,3,124,11,0,162,Moderate
2024-08-04 19:41:31.605066,Peelamedu,23,31,77,20,17,168,Moderate
2024-08-13 17:57:31.605066,Peelamedu,45,16,78,12,18,169,Low
2024-08-13 10:35:31.605066,Peelamedu,46,3,137,18,5,209,High
2024-07-28 15:14:31.605066,Peelamedu,91,23,74,17,8,213,Low
2024-08-05 07:21:31.605066,Peelamedu,58,15,84,17,20,194,High
2024-08-20 17:51:31.605066,Peelamedu,35,27,13,16,28,119,Moderate
2024-08-28 13:37:31.605066,Peelamedu,32,33,120,11,12,208,Moderate
2024-09-11 14:49:31.605066,Peelamedu,97,33,138,1,28,297,Moderate
2024-09-21 18:01:31.605066,Peelamedu,94,50,121,1,28,294,Low
2024-08-24 11:22:31.605066,Peelamedu,40,13,5,17,1,76,Low
2024-08-18 15:08:31.605066,Peelamedu,70,13,33,5,19,140,High
2024-09-11 11:43:31.605066,Peelamedu,71,18,96,10,4,199,Low
2024-08-04 04:40:31.605066,Peelamedu,8,1,141,18,9,177,Moderate
2024-08-17 22:10:31.605066,Peelamedu,70,36,41,19,27,193,High
2024-08-10 23:58:31.605066,Peelamedu,86,41,139,17,18,301,Low
2024-09-19 20:15:31.605066,Peelamedu,23,35,5,20,5,88,Moderate
2024-09-08 03:37:31.605066,Peelamedu,2,45,32,2,8,89,High
2024-09-11 15:14:31.605066,Peelamedu,78,41,116,13,24,272,High
2024-09-11 17:03:31.605066,Peelamedu,53,23,123,8,17,224,High
2024-08-12 05:18:31.605066,Peelamedu,92,45,68,0,5,210,High
2024-09-01 04:09:31.605066,Peelamedu,67,19,37,5,20,148,Moderate
2024-07-31 15:59:31.605066,Peelamedu,96,14,141,1,29,281,Moderate
2024-08-26 10:36:31.605066,Peelamedu,3,32,16,7,5,63,High
2024-09-18 01:39:31.605066,Peelamedu,2,6,61,13,15,97,High
2024-08-07 13:44:31.605066,Peelamedu,58,22,49,7,28,164,High
2024-08-27 05:41:31.605066,Peelamedu,87,3,23,9,22,144,High
2024-08-14 22:33:31.605066,Peelamedu,14,45,53,15,7,134,High
2024-08-27 17:14:31.605066,Peelamedu,78,50,16,3,16,163,Low
2024-09-06 15:37:31.605066,Peelamedu,17,12,134,13,23,199,Low
2024-08-17 18:42:31.605066,Peelamedu,20,43,8,14,19,104,Moderate
2024-09-17 11:19:31.605066,Peelamedu,97,14,21,10,28,170,Low
2024-08-29 13:52:31.605066,Peelamedu,68,13,6,5,22,114,Moderate
2024-07-27 17:03:31.605066,Peelamedu,3,42,89,19,10,163,Moderate
2024-09-15 11:53:31.605066,Peelamedu,90,8,29,10,27,164,Moderate
2024-08-19 17:33:31.605066,Peelamedu,23,22,93,4,3,145,Low
2024-09-18 07:55:31.605066,Peelamedu,35,24,120,10,1,190,Moderate
2024-08-30 17:00:31.605066,Peelamedu,13,40,132,20,20,225,Low
2024-09-12 05:49:31.605066,Peelamedu,22,15,127,4,23,191,High
2024-09-23 10:04:31.605066,Peelamedu,52,32,82,7,26,199,High
2024-09-02 10:10:31.605066,Peelamedu,78,10,75,19,5,187,Moderate
2024-08-22 12:44:31.605066,Peelamedu,79,3,28,16,11,137,Moderate
2024-08-21 16:31:31.605066,Peelamedu,84,47,130,0,1,262,Moderate
2024-09-21 17:22:31.605066,Peelamedu,79,25,88,1,2,195,Moderate
2024-08-31 18:42:31.605066,Peelamedu,41,0,145,14,29,229,Low
2024-08-30 13:21:31.605066,Peelamedu,41,43,0,6,30,120,Low
2024-07-31 00:44:31.605066,Peelamedu,49,37,66,13,3,168,High
2024-08-15 00:54:31.605066,Peelamedu,20,17,23,13,10,83,Moderate
2024-09-25 15:59:31.605066,Peelamedu,89,14,44,16,24,187,Moderate
2024-08-06 05:05:31.605066,Peelamedu,80,40,78,14,28,240,High
2024-08-15 23:03:31.605066,Peelamedu,31,42,48,19,24,164,Moderate
2024-08-19 00:06:31.605066,Peelamedu,31,22,77,0,6,136,Low
2024-09-26 04:03:31.605066,Peelamedu,42,22,135,7,29,235,Low
2024-08-04 21:17:31.605066,Peelamedu,88,17,128,14,15,262,Moderate
2024-09-19 13:10:31.605066,Peelamedu,42,18,96,12,22,190,High
2024-09-13 09:15:31.605066,Peelamedu,26,23,91,9,15,164,Low
2024-08-31 00:16:31.605066,Peelamedu,69,20,139,20,20,268,Moderate
2024-08-27 05:17:31.605066,Peelamedu,98,20,52,7,12,189,Moderate
2024-09-24 10:04:31.605066,Peelamedu,60,16,129,13,27,245,High
2024-07-28 03:14:31.605066,Peelamedu,27,24,34,15,4,104,High
2024-08-15 00:52:31.605066,Peelamedu,68,40,41,18,8,175,Low
2024-09-14 21:38:31.605066,Peelamedu,85,2,3,11,16,117,High
2024-09-16 16:49:31.605066,Peelamedu,44,3,15,14,6,82,Moderate
2024-08-16 19:57:31.605066,Peelamedu,0,26,79,18,18,141,Low
2024-09-14 00:57:31.605066,Peelamedu,86,0,108,4,21,219,Low
2024-09-24 10:22:31.605066,Peelamedu,14,26,51,8,16,115,High
2024-08-05 12:53:31.605066,Peelamedu,37,4,14,8,20,83,High
2024-09-12 15:10:31.605066,Peelamedu,2,29,114,12,28,185,Moderate
